"trackingcode","trackingcode","event31","event95","event29","event30","event94","event38","event33","event32"
"em_5363243",NA,54969,41458,2565286,640940,503528,2573973,8687,2605
"em_5371968",NA,54934,41173,2564521,529117,425606,2568088,3567,2520
"em_5356046",NA,22590,14678,514901,131784,95244,517151,2250,544
"em_5356044",NA,22538,14625,514806,129165,93203,516956,2150,568
"em_5356045",NA,21914,14611,514697,130062,94652,516913,2216,550
"em_5356047",NA,20731,13590,514874,126254,92243,517152,2278,556
"em_5356048",NA,15800,10713,515184,119006,89902,517086,1902,503
"em_5359303",NA,12227,9808,473507,97797,78841,481343,7836,973
"em_5371149",NA,8967,6793,476547,84796,67996,479002,2455,359
"em_5371154",NA,8884,6824,442066,86979,69176,443080,1014,279
"em_5367419",NA,8705,6432,469465,82080,66013,472198,2733,428
"em_5367435",NA,8302,6137,467543,81063,66025,470366,2823,394
"em_5367427",NA,8078,6125,468022,80658,65786,471214,3192,448
"em_5370542",NA,5971,3428,23095,17910,9636,23345,250,6
"em_5344022",NA,5379,2970,-3,40243,19718,0,3,481
"em_5349076",NA,5109,3642,-2885,61817,38952,0,2885,458
"em_5359302",NA,2769,2177,65546,17826,13531,66037,491,72
"em_5370547",NA,2396,1319,6171,6259,3116,6402,231,3
"em_5366690",NA,2076,1150,7129,7825,3533,7250,121,11
"em_5337430",NA,2053,840,-1,17858,9133,0,1,194
"em_5327998",NA,1340,343,-1,10058,4426,0,1,95
"em_5347766",NA,1272,535,-66,4173,1030,0,66,6
"em_5358990",NA,1193,699,6618,6448,3189,6869,251,0
"em_5366699",NA,1121,611,3324,4068,1820,3458,134,2
"em_5366812",NA,963,616,6393,6078,3175,6649,256,7
"em_5347771",NA,767,247,-7,2037,330,0,7,1
"em_5359008",NA,654,412,4452,4828,2379,4684,232,9
"em_5355618",NA,584,451,10761,5790,3922,11090,329,11
"em_5362875",NA,536,240,775,1281,492,812,37,0
"em_5344238",NA,483,156,0,1579,245,0,0,3
"em_5362930",NA,446,308,6361,3580,2270,6484,123,2
"em_5370541",NA,401,307,3434,2922,1805,3483,49,0
"em_5325177",NA,397,104,0,1231,180,0,0,0
"em_5355619",NA,394,293,7110,4365,2931,7494,384,13
"em_5362938",NA,324,222,3780,2626,1569,3942,162,2
"em_5347723",NA,322,133,-27,853,97,0,27,0
"em_5359001",NA,318,264,12085,7567,5369,12711,626,17
"em_5282099",NA,266,71,0,645,94,0,0,3
"em_5321867",NA,264,69,0,649,56,0,0,1
"em_5366986",NA,262,165,1438,1402,754,1481,43,0
"em_5296554",NA,261,156,0,4638,2091,0,0,71
"em_5344249",NA,258,85,0,818,100,0,0,1
"em_5314402",NA,256,158,0,5149,2418,0,0,88
"em_5302529",NA,255,70,0,769,95,0,0,1
"em_5362885",NA,251,102,452,553,239,462,10,0
"em_5325187",NA,242,51,0,531,73,0,0,0
"em_5282047",NA,236,63,0,1294,132,0,0,0
"em_5238827",NA,233,58,0,1168,65,0,0,0
"em_5366580",NA,217,6,24,27,7,24,0,0
"em_5337089",NA,215,70,0,988,220,0,0,2
"em_5362932",NA,213,113,599,796,320,631,32,0
"em_5344216",NA,207,79,0,868,158,0,0,1
"em_5366656",NA,203,95,1097,863,406,1118,21,2
"em_5366579",NA,186,6,24,35,8,24,0,0
"em_5370538",NA,184,6,24,16,9,24,0,0
"em_5370543",NA,176,6,24,14,7,24,0,0
"em_5321871",NA,160,42,0,417,44,0,0,0
"em_5367030",NA,160,5,24,15,6,24,0,0
"em_5366582",NA,158,6,24,21,10,24,0,0
"em_5367027",NA,151,6,24,14,6,24,0,0
"em_5355599",NA,148,11,41,26,12,46,5,0
"em_5367029",NA,136,5,24,10,5,24,0,0
"em_5344188",NA,131,35,0,693,104,0,0,1
"em_5355551",NA,130,102,7244,2217,1685,8045,801,13
"em_5340658",NA,122,42,0,551,45,0,0,0
"em_5299304",NA,107,25,0,256,31,0,0,0
"em_5367251",NA,107,6,24,14,7,24,0,0
"em_5347767",NA,105,50,-10,615,156,0,10,1
"em_5370735",NA,105,6,24,10,7,24,0,0
"em_5321813",NA,102,27,0,362,42,0,0,0
"em_5367280",NA,100,3,24,8,5,24,0,0
"em_5355601",NA,99,11,41,19,13,46,5,0
"em_5337118",NA,97,30,0,531,77,0,0,0
"em_5362933",NA,96,55,203,409,131,224,21,0
"em_5367278",NA,93,3,24,10,4,24,0,0
"em_5337627",NA,89,45,0,733,372,0,0,5
"em_5302536",NA,84,22,0,269,28,0,0,2
"em_5262282",NA,84,21,0,381,25,0,0,0
"em_5269674",NA,82,43,-1,2259,796,0,1,36
"em_5299312",NA,82,14,0,201,15,0,0,0
"em_5362866",NA,82,4,46,38,8,46,0,0
"em_5370771",NA,79,3,24,8,4,24,0,0
"em_5348131",NA,78,43,-9,560,187,0,9,0
"em_5367279",NA,78,2,24,5,2,24,0,0
"em_5370545",NA,76,60,622,563,375,656,34,1
"em_4977957",NA,76,17,0,56,13,0,0,1
"em_5358985",NA,73,59,3983,2095,1562,4117,134,2
"em_5262372",NA,72,30,0,658,30,0,0,0
"em_5355887",NA,72,9,1,91,1,1,0,0
"em_5370774",NA,71,2,24,8,3,24,0,0
"em_5355600",NA,70,11,41,19,12,46,5,0
"em_5355884",NA,70,9,1,127,1,1,0,0
"em_5355888",NA,69,10,1,89,1,1,0,0
"em_5355891",NA,69,9,1,98,1,1,0,0
"em_5355893",NA,69,9,1,94,1,1,0,0
"em_5359109",NA,67,1,1,14,1,1,0,0
"em_5314708",NA,66,36,0,978,568,0,0,24
"em_5278917",NA,66,15,0,176,17,0,0,0
"em_5355604",NA,66,11,41,18,10,46,5,0
"em_5355603",NA,63,12,41,24,15,46,5,0
"em_5344218",NA,62,41,0,493,163,0,0,1
"em_5359074",NA,62,4,46,11,8,46,0,0
"em_5362931",NA,61,23,113,169,66,121,8,0
"em_5358550",NA,61,3,46,15,5,46,0,0
"em_5362884",NA,59,45,240,240,126,245,5,0
"em_5355811",NA,59,3,20,5,3,21,1,0
"em_5262335",NA,57,10,0,164,12,0,0,0
"em_5258956",NA,55,10,0,144,10,0,0,0
"em_5359076",NA,55,1,1,19,1,1,0,0
"em_5340694",NA,53,11,0,96,9,0,0,0
"em_5370582",NA,53,3,48,9,7,48,0,0
"em_5368872",NA,52,35,650,745,365,651,1,0
"em_5282111",NA,52,11,0,183,11,0,0,0
"em_5370480",NA,52,7,38,20,8,38,0,0
"em_5355815",NA,52,3,20,4,4,21,1,0
"em_5355554",NA,51,32,846,477,315,882,36,2
"em_5255753",NA,51,7,0,137,10,0,0,0
"em_5292719",NA,49,21,0,254,34,0,0,0
"em_5171681",NA,49,16,-1,402,43,0,1,0
"em_5228038",NA,48,15,0,268,28,0,0,0
"em_5340699",NA,46,13,0,129,15,0,0,0
"em_5355651",NA,46,3,46,6,6,46,0,0
"em_5355550",NA,45,36,2784,762,619,2991,207,2
"em_5355816",NA,44,3,20,14,5,21,1,0
"em_5314163",NA,43,11,0,292,34,0,0,0
"em_5303095",NA,42,25,0,1126,642,0,0,21
"em_5278997",NA,42,11,0,136,14,0,0,0
"em_5262279",NA,42,10,0,212,14,0,0,0
"em_5333434",NA,41,25,0,699,219,0,0,1
"em_5241539",NA,41,12,0,240,23,0,0,0
"em_5220775",NA,41,7,0,113,9,0,0,0
"em_5355820",NA,41,3,20,9,4,21,1,0
"em_5336568",NA,40,17,0,238,79,0,0,2
"em_5355908",NA,40,1,1,12,1,1,0,0
"em_5282105",NA,39,15,0,267,30,0,0,0
"em_5325172",NA,39,13,0,198,6,0,0,0
"em_5344247",NA,38,21,0,403,92,0,0,1
"em_5344215",NA,38,17,0,186,37,0,0,1
"em_5370776",NA,38,3,24,10,4,24,0,0
"em_5357891",NA,38,2,18,234,16,18,0,0
"em_5299293",NA,38,1,0,126,4,0,0,0
"em_5180819",NA,36,12,0,171,19,0,0,0
"em_5367216",NA,36,3,24,4,3,24,0,0
"em_5355913",NA,36,1,1,8,1,1,0,0
"em_5366702",NA,35,18,113,138,61,117,4,0
"em_5314223",NA,35,6,0,205,26,0,0,0
"em_5278919",NA,35,6,0,91,15,0,0,0
"em_5235059",NA,35,5,0,167,4,0,0,0
"em_5355924",NA,35,1,1,10,1,1,0,0
"em_5032220",NA,35,1,0,58,1,0,0,0
"em_5238565",NA,34,9,0,110,14,0,0,0
"em_5355920",NA,34,1,1,5,1,1,0,0
"em_5333435",NA,33,15,0,355,105,0,0,1
"em_5299443",NA,33,13,0,175,15,0,0,1
"em_5355813",NA,33,3,20,3,2,21,1,0
"em_5357940",NA,33,3,18,237,14,18,0,0
"em_5241550",NA,32,9,0,83,5,0,0,0
"em_5258961",NA,31,12,0,127,15,0,0,0
"em_5355724",NA,31,4,50,22,9,50,0,0
"em_5366399",NA,31,2,18,224,15,18,0,0
"em_5355912",NA,31,1,1,6,1,1,0,0
"em_5354941",NA,30,1,1,28,1,1,0,0
"em_5303094",NA,29,21,0,1063,597,0,0,36
"em_5325178",NA,29,19,0,214,36,0,0,0
"em_5317989",NA,29,14,0,138,29,0,0,0
"em_5235321",NA,29,12,0,528,213,0,0,3
"em_5272369",NA,29,6,0,140,15,0,0,0
"em_5363101",NA,29,1,1,3,1,1,0,0
"em_5235356",NA,28,0,0,27,0,0,0,0
"em_5269251",NA,27,12,0,140,16,0,0,0
"em_5255954",NA,27,8,0,71,12,0,0,0
"em_5358992",NA,27,1,1,18,1,1,0,0
"em_5174146",NA,26,0,0,23,0,0,0,0
"em_5194076",NA,25,8,0,127,13,0,0,0
"em_5252261",NA,24,9,0,151,13,0,0,0
"em_5367252",NA,24,6,24,8,6,24,0,0
"em_5296086",NA,24,3,0,116,3,0,0,0
"em_5091347",NA,24,2,0,261,99,0,0,3
"em_5217687",NA,24,2,0,96,3,0,0,0
"em_5355553",NA,24,1,1,27,1,1,0,0
"em_5362886",NA,23,14,35,48,22,35,0,0
"em_5105920",NA,23,7,0,381,159,0,0,5
"em_5235355",NA,23,7,0,83,1,0,0,0
"em_5355571",NA,22,2,46,20,8,46,0,0
"em_5148304",NA,21,9,0,67,6,0,0,0
"em_5362887",NA,21,7,39,82,23,46,7,0
"em_5200619",NA,21,7,0,105,9,0,0,0
"em_5355315",NA,21,6,41,100,10,46,5,0
"em_5340702",NA,21,6,0,140,7,0,0,0
"em_5370307",NA,21,1,1,3,1,1,0,0
"em_5347778",NA,20,11,-2,123,26,0,2,0
"em_5207458",NA,20,10,0,147,26,0,0,0
"em_5137391",NA,20,6,0,176,15,0,0,0
"em_5358466",NA,20,1,1,5,1,1,0,0
"em_5363109",NA,20,1,1,2,1,1,0,0
"em_5337117",NA,19,13,0,509,179,0,0,2
"em_5015553",NA,19,10,0,210,58,0,0,0
"em_5367253",NA,19,6,24,8,8,24,0,0
"em_5355628",NA,19,1,1,25,1,1,0,0
"em_5289602",NA,18,13,0,616,300,0,0,15
"em_5191145",NA,18,9,0,306,89,0,0,3
"em_5317978",NA,18,8,0,93,13,0,0,0
"em_5314710",NA,18,6,0,213,96,0,0,2
"em_4891165",NA,18,6,0,209,46,0,0,1
"em_5197375",NA,18,3,0,87,9,0,0,0
"em_5318049",NA,18,2,0,51,3,0,0,0
"em_5358152",NA,18,1,50,8,4,50,0,0
"em_5318050",NA,17,7,0,133,27,0,0,2
"em_5079588",NA,17,2,0,75,1,0,0,0
"em_4994713",NA,17,2,0,40,1,0,0,0
"em_5358631",NA,17,1,1,8,1,1,0,0
"em_5362882",NA,16,12,257,185,121,263,6,0
"em_5177812",NA,16,6,0,262,105,0,0,5
"em_5367208",NA,16,3,24,13,6,24,0,0
"em_5296101",NA,16,1,0,34,1,0,0,0
"em_5244075",NA,15,12,0,338,205,0,0,10
"em_5187777",NA,15,6,0,104,12,0,0,0
"em_5161449",NA,15,1,0,72,5,0,0,0
"em_5193990",NA,14,8,0,481,242,0,0,10
"em_5099891",NA,14,8,0,434,142,0,0,5
"em_5200086",NA,14,6,-1,300,97,0,1,4
"em_5358160",NA,14,5,41,30,11,46,5,0
"em_5238567",NA,14,4,0,39,2,0,0,0
"em_5296092",NA,14,4,0,19,4,0,0,0
"em_5317994",NA,14,3,0,71,5,0,0,0
"em_5220786",NA,14,3,0,26,1,0,0,0
"em_5363125",NA,14,1,1,1,1,1,0,0
"em_5154694",NA,14,1,0,24,0,0,0,0
"em_4977996",NA,14,0,0,169,55,0,0,1
"em_5293243",NA,13,9,0,368,206,0,0,14
"em_5214019",NA,13,9,-1,729,396,0,1,9
"em_5248771",NA,13,5,0,74,6,0,0,1
"em_4887544",NA,13,3,0,151,11,0,0,0
"em_5018269",NA,13,2,0,286,80,0,0,0
"em_5363123",NA,13,1,1,2,1,1,0,0
"em_5275569",NA,13,1,0,15,1,0,0,0
"em_5235357",NA,13,0,0,22,0,0,0,0
"em_4950093",NA,12,8,0,239,55,0,0,0
"em_5310549",NA,12,6,0,167,34,0,0,0
"em_5269306",NA,12,6,0,75,12,0,0,0
"em_5275523",NA,12,6,0,51,9,0,0,0
"em_5238840",NA,12,4,0,96,6,0,0,0
"em_5292731",NA,12,3,0,153,10,0,0,1
"em_5171928",NA,12,3,0,136,52,0,0,0
"em_5140979",NA,12,3,0,55,5,0,0,0
"em_5127562",NA,12,3,0,18,2,0,0,0
"em_5070428",NA,12,2,0,113,47,0,0,0
"em_5363126",NA,12,1,1,2,1,1,0,0
"em_5262280",NA,12,1,0,45,2,0,0,0
"em_4830189",NA,12,0,0,93,27,0,0,0
"em_5347566",NA,12,0,0,9,0,0,0,0
"em_5201257",NA,11,9,-2,676,314,0,2,10
"em_5345878",NA,11,7,-3,185,26,0,3,0
"em_5282100",NA,11,6,0,46,9,0,0,1
"em_5344246",NA,11,5,0,53,7,0,0,0
"em_5367218",NA,11,1,24,2,1,24,0,0
"em_5355505",NA,10,7,244,149,89,254,10,0
"em_5161240",NA,10,6,0,212,70,0,0,6
"em_5310550",NA,10,5,0,120,19,0,0,0
"em_5241540",NA,10,4,0,76,10,0,0,0
"em_5197388",NA,10,4,0,32,4,0,0,0
"em_4870435",NA,10,1,0,9,0,0,0,0
"em_5222585",NA,9,8,-1,629,378,0,1,12
"em_5281893",NA,9,7,-1,473,293,0,1,8
"em_5367211",NA,9,4,24,5,4,24,0,0
"em_5358403",NA,9,4,18,200,16,18,0,0
"em_5078179",NA,9,4,0,136,67,0,0,3
"em_5210524",NA,9,3,0,52,6,0,0,0
"em_5059706",NA,9,3,0,38,3,0,0,0
"em_5096747",NA,9,2,0,289,114,0,0,6
"em_5177754",NA,9,2,0,108,10,0,0,0
"em_5231595",NA,9,2,0,96,12,0,0,0
"em_5200731",NA,9,2,0,35,1,0,0,0
"em_5158258",NA,9,0,0,50,0,0,0,0
"em_5205055",NA,8,7,-1,681,373,0,1,5
"em_5281892",NA,8,6,0,457,229,0,0,7
"em_5141302",NA,8,6,0,406,162,0,0,3
"em_5218069",NA,8,5,0,428,178,0,0,2
"em_5035563",NA,8,5,0,156,59,0,0,4
"em_5032599",NA,8,4,0,261,96,0,0,3
"em_5272378",NA,8,4,0,70,9,0,0,0
"em_5063196",NA,8,3,0,340,101,0,0,2
"em_5302530",NA,8,3,0,84,10,0,0,0
"em_5367386",NA,8,2,24,4,2,24,0,0
"em_5370081",NA,8,1,1,2,1,1,0,0
"em_5154679",NA,8,0,0,4,0,0,0,0
"em_5121263",NA,7,6,0,300,107,0,0,4
"em_5218070",NA,7,6,-1,309,151,0,1,2
"em_5259210",NA,7,5,0,294,133,0,0,3
"em_5318047",NA,7,5,0,38,1,0,0,0
"em_5357873",NA,7,4,50,12,5,50,0,0
"em_4930365",NA,7,4,0,196,42,0,0,0
"em_4955077",NA,7,4,0,79,4,0,0,0
"em_4957976",NA,7,3,0,101,4,0,0,0
"em_5325186",NA,7,3,0,58,9,0,0,0
"em_5340689",NA,7,3,0,39,6,0,0,0
"em_4855537",NA,7,2,0,96,19,0,0,0
"em_5194091",NA,7,2,0,26,1,0,0,0
"em_5340695",NA,7,2,0,14,2,0,0,0
"em_5370103",NA,7,1,1,4,1,1,0,0
"em_5358630",NA,7,1,1,3,1,1,0,0
"em_5038533",NA,7,1,0,88,6,0,0,0
"em_5056438",NA,7,1,0,64,4,0,0,0
"em_5282091",NA,7,1,0,30,3,0,0,0
"em_5120935",NA,7,1,0,21,1,0,0,0
"em_4937808",NA,7,1,0,16,2,0,0,0
"em_5133776",NA,7,0,0,27,0,0,0,0
"em_5194010",NA,7,0,0,19,0,0,0,0
"em_5296093",NA,7,0,0,10,1,0,0,0
"em_4951687",NA,7,0,0,4,0,0,0,0
"em_5158721",NA,6,4,0,360,180,0,0,3
"em_5272807",NA,6,4,0,251,124,0,0,5
"em_5142509",NA,6,4,0,206,109,0,0,1
"em_5296097",NA,6,3,0,72,16,0,0,0
"em_5187782",NA,6,3,0,14,1,0,0,0
"em_5122186",NA,6,2,0,125,53,0,0,7
"em_4857596",NA,6,2,0,98,31,0,0,1
"em_5231612",NA,6,2,0,44,3,0,0,0
"em_5059698",NA,6,2,0,25,2,0,0,0
"em_5018458",NA,6,0,0,13,1,0,0,0
"em_5343456",NA,6,0,0,5,0,0,0,0
"em_4996678",NA,5,4,0,266,88,0,0,1
"em_5292730",NA,5,4,0,88,14,0,0,0
"em_5189971",NA,5,4,0,75,40,0,0,4
"em_5349063",NA,5,4,0,14,11,0,0,0
"em_5359500",NA,5,3,103,155,40,103,0,1
"em_5355318",NA,5,3,41,36,7,46,5,0
"em_5243062",NA,5,3,0,362,158,0,0,1
"em_5099729",NA,5,3,0,63,2,0,0,0
"em_5321812",NA,5,3,0,57,9,0,0,0
"em_5340690",NA,5,3,0,57,2,0,0,0
"em_5194152",NA,5,3,0,20,1,0,0,0
"em_5356042",NA,5,2,198,10,5,198,0,0
"em_5325709",NA,5,2,0,84,7,0,0,0
"em_4964635",NA,5,2,0,72,4,0,0,0
"em_5248783",NA,5,2,0,45,5,0,0,0
"em_5340692",NA,5,2,0,15,2,0,0,0
"em_5235067",NA,5,2,0,7,0,0,0,0
"em_5250072",NA,5,2,-1,143,65,0,1,4
"em_5359054",NA,5,1,1,23,1,1,0,0
"em_5127558",NA,5,1,0,34,3,0,0,0
"em_5200629",NA,5,1,0,23,1,0,0,0
"em_5120942",NA,5,1,0,19,2,0,0,0
"em_5140994",NA,5,1,0,15,1,0,0,0
"em_5130627",NA,5,1,0,10,2,0,0,0
"em_5154623",NA,5,1,0,6,0,0,0,0
"em_5296099",NA,5,0,0,34,2,0,0,0
"em_4997251",NA,5,0,0,21,0,0,0,0
"em_5238456",NA,5,0,0,8,0,0,0,0
"em_5100782",NA,4,4,0,298,111,0,0,6
"em_5005823",NA,4,4,0,192,74,0,0,2
"em_5337085",NA,4,4,0,122,46,0,0,0
"em_4887458",NA,4,4,0,64,18,0,0,1
"em_5367210",NA,4,3,24,6,4,24,0,0
"em_5259211",NA,4,3,0,317,157,0,0,0
"em_5061291",NA,4,3,0,275,120,0,0,3
"em_5162036",NA,4,3,0,269,127,0,0,3
"em_5042102",NA,4,3,0,144,56,0,0,2
"em_5130649",NA,4,3,0,125,58,0,0,1
"em_4986562",NA,4,3,0,102,62,0,0,2
"em_5200087",NA,4,3,0,52,23,0,0,2
"em_5259213",NA,4,2,0,199,127,0,0,4
"em_4877631",NA,4,2,0,151,40,0,0,1
"em_4978415",NA,4,2,0,132,67,0,0,3
"em_5046816",NA,4,2,0,45,5,0,0,0
"em_4951631",NA,4,2,0,43,3,0,0,0
"em_5197390",NA,4,2,0,26,1,0,0,0
"em_5238383",NA,4,1,0,62,4,0,0,0
"em_5295906",NA,4,1,0,52,10,0,0,1
"em_5299296",NA,4,1,0,45,4,0,0,0
"em_5161459",NA,4,1,0,43,7,0,0,0
"em_5296106",NA,4,1,0,29,7,0,0,1
"em_5217692",NA,4,1,0,19,2,0,0,0
"em_5053261",NA,4,1,0,15,1,0,0,0
"em_5255751",NA,4,1,0,7,0,0,0,0
"em_4861399",NA,4,1,0,6,1,0,0,0
"em_5214013",NA,4,0,0,4,0,0,0,0
"em_5314702",NA,4,0,0,3,0,0,0,0
"em_5293241",NA,4,0,0,3,0,0,0,0
"em_5358105",NA,3,3,18,247,18,18,0,0
"em_5243063",NA,3,3,0,296,176,0,0,8
"em_5259212",NA,3,3,0,188,106,0,0,7
"em_5333433",NA,3,3,0,118,63,0,0,0
"em_5174847",NA,3,3,0,82,33,0,0,0
"em_5228216",NA,3,2,0,119,51,0,0,2
"em_5040119",NA,3,2,0,105,55,0,0,2
"em_4832700",NA,3,2,0,92,18,0,0,0
"em_5278877",NA,3,2,0,61,5,0,0,0
"em_5252266",NA,3,2,0,43,9,0,0,0
"em_5220712",NA,3,2,0,30,1,0,0,0
"em_5107060",NA,3,2,0,20,1,0,0,0
"em_5008691",NA,3,2,0,14,3,0,0,0
"em_5161239",NA,3,2,-1,191,50,0,1,3
"em_5371141",NA,3,1,24,1,1,24,0,0
"em_5357895",NA,3,1,1,28,1,1,0,0
"em_5358996",NA,3,1,1,11,1,1,0,0
"em_5363120",NA,3,1,1,3,1,1,0,0
"em_5358633",NA,3,1,1,3,1,1,0,0
"em_5358586",NA,3,1,1,2,1,1,0,0
"em_4897026",NA,3,1,0,185,63,0,0,1
"em_4937980",NA,3,1,0,70,14,0,0,0
"em_5275500",NA,3,1,0,48,1,0,0,0
"em_4916433",NA,3,1,0,37,9,0,0,0
"em_5015709",NA,3,1,0,36,14,0,0,0
"em_5011932",NA,3,1,0,33,3,0,0,0
"em_5255963",NA,3,1,0,32,5,0,0,0
"em_4908208",NA,3,1,0,29,0,0,0,0
"em_5207463",NA,3,1,0,26,4,0,0,0
"em_5028824",NA,3,1,0,24,0,0,0,0
"em_5107074",NA,3,1,0,10,1,0,0,0
"em_5028831",NA,3,1,0,8,0,0,0,0
"em_5194070",NA,3,1,0,2,0,0,0,0
"em_4829785",NA,3,0,0,46,12,0,0,0
"em_5262281",NA,3,0,0,46,7,0,0,0
"em_4904838",NA,3,0,0,27,1,0,0,0
"em_5275571",NA,3,0,0,19,0,0,0,1
"em_5177761",NA,3,0,0,18,2,0,0,0
"em_5194074",NA,3,0,0,13,0,0,0,0
"em_5214219",NA,3,0,0,10,0,0,0,0
"em_5327989",NA,3,0,0,2,0,0,0,0
"em_5355320",NA,2,2,41,31,6,46,5,0
"em_5355317",NA,2,2,41,24,5,46,5,0
"em_5355316",NA,2,2,41,19,3,46,5,0
"em_5032186",NA,2,2,0,186,82,0,0,1
"em_5063092",NA,2,2,0,164,89,0,0,3
"em_4956649",NA,2,2,0,148,71,0,0,8
"em_5080255",NA,2,2,0,148,42,0,0,2
"em_5293244",NA,2,2,0,106,44,0,0,1
"em_5060003",NA,2,2,0,103,45,0,0,1
"em_5295905",NA,2,2,0,98,21,0,0,1
"em_5314161",NA,2,2,0,42,13,0,0,0
"em_5050046",NA,2,2,0,31,4,0,0,0
"em_5228047",NA,2,2,0,27,3,0,0,0
"em_5228217",NA,2,2,0,23,8,0,0,2
"em_5005478",NA,2,2,0,18,1,0,0,0
"em_5130629",NA,2,2,0,17,2,0,0,0
"em_5282109",NA,2,2,0,13,0,0,0,0
"em_5310487",NA,2,2,0,11,0,0,0,0
"em_5355269",NA,2,1,1,31,1,1,0,0
"em_5358600",NA,2,1,1,7,1,1,0,0
"em_5359064",NA,2,1,1,5,1,1,0,0
"em_5370385",NA,2,1,1,4,1,1,0,0
"em_5370105",NA,2,1,1,3,1,1,0,0
"em_4894042",NA,2,1,0,197,73,0,0,6
"em_4918400",NA,2,1,0,142,64,0,0,0
"em_5080254",NA,2,1,0,138,55,0,0,0
"em_4863234",NA,2,1,0,73,23,0,0,1
"em_5130596",NA,2,1,0,73,1,0,0,0
"em_4919480",NA,2,1,0,69,3,0,0,0
"em_4964202",NA,2,1,0,66,26,0,0,0
"em_5110445",NA,2,1,0,35,3,0,0,0
"em_4913095",NA,2,1,0,27,10,0,0,0
"em_5099790",NA,2,1,0,27,2,0,0,0
"em_5255855",NA,2,1,0,26,2,0,0,0
"em_4945111",NA,2,1,0,25,11,0,0,0
"em_5180820",NA,2,1,0,25,2,0,0,0
"em_5120934",NA,2,1,0,25,1,0,0,0
"em_5171686",NA,2,1,0,22,2,0,0,0
"em_4897668",NA,2,1,0,22,0,0,0,0
"em_5200615",NA,2,1,0,21,1,0,0,0
"em_5148328",NA,2,1,0,20,2,0,0,0
"em_4987985",NA,2,1,0,16,1,0,0,0
"em_5177770",NA,2,1,0,16,1,0,0,0
"em_4981252",NA,2,1,0,14,5,0,0,0
"em_5011977",NA,2,1,0,9,0,0,0,0
"em_4852896",NA,2,1,0,4,0,0,0,0
"em_5269672",NA,2,1,0,3,1,0,0,0
"em_5222577",NA,2,1,0,2,1,0,0,0
"em_5053330",NA,2,1,0,2,0,0,0,0
"em_5344632",NA,2,1,0,2,0,0,0,0
"em_5337403",NA,2,1,0,1,1,0,0,0
"em_5214167",NA,2,1,0,1,0,0,0,0
"em_4901293",NA,2,0,0,62,22,0,0,0
"em_5272808",NA,2,0,0,60,21,0,0,1
"em_5190860",NA,2,0,0,47,8,0,0,0
"em_4934731",NA,2,0,0,37,6,0,0,0
"em_4837439",NA,2,0,0,35,18,0,0,0
"em_5151616",NA,2,0,0,33,5,0,0,0
"em_4998177",NA,2,0,0,28,3,0,0,0
"em_5197392",NA,2,0,0,14,2,0,0,0
"em_5076216",NA,2,0,0,11,1,0,0,0
"em_5025607",NA,2,0,0,11,1,0,0,0
"em_5099758",NA,2,0,0,9,2,0,0,0
"em_4849712",NA,2,0,0,7,0,0,0,0
"em_4974218",NA,2,0,0,6,1,0,0,0
"em_5347812",NA,2,0,0,5,3,0,0,0
"em_5113794",NA,2,0,0,5,0,0,0,0
"em_5181247",NA,2,0,0,5,0,0,0,0
"em_5194022",NA,2,0,0,4,1,0,0,0
"em_5235057",NA,2,0,0,4,0,0,0,0
"em_4967857",NA,2,0,0,4,0,0,0,0
"em_4890930",NA,2,0,0,3,0,0,0,0
"em_5012080",NA,2,0,0,3,0,0,0,0
"em_5133860",NA,2,0,0,3,0,0,0,0
"em_5275850",NA,2,0,0,2,0,0,0,0
"em_5167934",NA,2,0,0,1,0,0,0,0
"em_5296094",NA,2,0,0,1,0,0,0,0
"em_5133841",NA,2,0,0,0,0,0,0,0
"em_5292105",NA,2,0,0,0,0,0,0,0
"em_5292879",NA,2,0,0,0,0,0,0,0
"em_5356039",NA,1,1,198,3,3,198,0,0
"em_5366992",NA,1,1,154,24,7,154,0,0
"em_5363226",NA,1,1,36,8,8,43,7,0
"em_5359301",NA,1,1,35,4,4,35,0,0
"em_5367418",NA,1,1,24,5,3,24,0,0
"em_5362880",NA,1,1,8,4,1,8,0,0
"em_5355499",NA,1,1,1,31,1,1,0,0
"em_5355256",NA,1,1,1,29,1,1,0,0
"em_5355260",NA,1,1,1,28,1,1,0,0
"em_5355249",NA,1,1,1,24,1,1,0,0
"em_5355306",NA,1,1,1,23,1,1,0,0
"em_5355254",NA,1,1,1,23,1,1,0,0
"em_5363111",NA,1,1,1,3,1,1,0,0
"em_5363106",NA,1,1,1,1,1,1,0,0
"em_5363116",NA,1,1,1,1,1,1,0,0
"em_5363102",NA,1,1,1,1,1,1,0,0
"em_5363118",NA,1,1,1,1,1,1,0,0
"em_5363122",NA,1,1,1,1,1,1,0,0
"em_5363110",NA,1,1,1,1,1,1,0,0
"em_5363115",NA,1,1,1,1,1,1,0,0
"em_5363121",NA,1,1,1,1,1,1,0,0
"em_4997579",NA,1,1,0,215,72,0,0,3
"em_4959119",NA,1,1,0,163,78,0,0,5
"em_5022262",NA,1,1,0,163,77,0,0,2
"em_4951000",NA,1,1,0,140,60,0,0,3
"em_4864840",NA,1,1,0,129,51,0,0,2
"em_4899215",NA,1,1,0,103,45,0,0,0
"em_4964229",NA,1,1,0,87,39,0,0,0
"em_5174848",NA,1,1,0,79,27,0,0,0
"em_4859130",NA,1,1,0,68,20,0,0,1
"em_4947750",NA,1,1,0,65,31,0,0,1
"em_4903459",NA,1,1,0,60,17,0,0,0
"em_5310076",NA,1,1,0,56,5,0,0,0
"em_5171230",NA,1,1,0,52,27,0,0,1
"em_5321810",NA,1,1,0,41,3,0,0,0
"em_4903458",NA,1,1,0,40,14,0,0,0
"em_4927960",NA,1,1,0,35,8,0,0,0
"em_5340693",NA,1,1,0,35,2,0,0,0
"em_5252265",NA,1,1,0,34,10,0,0,0
"em_5070069",NA,1,1,0,34,5,0,0,0
"em_4884617",NA,1,1,0,33,7,0,0,0
"em_5056501",NA,1,1,0,33,1,0,0,0
"em_5282092",NA,1,1,0,30,2,0,0,0
"em_5259130",NA,1,1,0,29,0,0,0,0
"em_4842422",NA,1,1,0,28,19,0,0,2
"em_5180768",NA,1,1,0,28,0,0,0,0
"em_5068089",NA,1,1,0,25,13,0,0,0
"em_4941352",NA,1,1,0,24,16,0,0,0
"em_5347658",NA,1,1,0,22,6,0,0,0
"em_5333453",NA,1,1,0,22,3,0,0,0
"em_5180831",NA,1,1,0,21,2,0,0,0
"em_5137479",NA,1,1,0,21,1,0,0,0
"em_5235150",NA,1,1,0,20,4,0,0,0
"em_5007048",NA,1,1,0,19,11,0,0,0
"em_5325171",NA,1,1,0,19,0,0,0,0
"em_5160122",NA,1,1,0,18,2,0,0,0
"em_4877394",NA,1,1,0,16,2,0,0,0
"em_5241535",NA,1,1,0,15,1,0,0,0
"em_4884606",NA,1,1,0,14,6,0,0,0
"em_5279082",NA,1,1,0,14,4,0,0,0
"em_4959502",NA,1,1,0,13,0,0,0,0
"em_4908255",NA,1,1,0,12,4,0,0,0
"em_5200610",NA,1,1,0,12,0,0,0,0
"em_4894268",NA,1,1,0,12,0,0,0,0
"em_5241549",NA,1,1,0,10,2,0,0,0
"em_5069776",NA,1,1,0,10,1,0,0,0
"em_5151626",NA,1,1,0,9,2,0,0,0
"em_5278921",NA,1,1,0,9,0,0,0,0
"em_4885736",NA,1,1,0,8,5,0,0,1
"em_4884300",NA,1,1,0,8,1,0,0,0
"em_5310556",NA,1,1,0,7,2,0,0,0
"em_5038534",NA,1,1,0,7,1,0,0,0
"em_5235449",NA,1,1,0,6,0,0,0,0
"em_4924739",NA,1,1,0,6,0,0,0,0
"em_5139697",NA,1,1,0,5,5,0,0,1
"em_5117203",NA,1,1,0,5,1,0,0,0
"em_5069765",NA,1,1,0,5,0,0,0,0
"em_5317990",NA,1,1,0,5,0,0,0,0
"em_4974277",NA,1,1,0,5,0,0,0,0
"em_4863336",NA,1,1,0,5,0,0,0,0
"em_5264582",NA,1,1,0,4,2,0,0,0
"em_4894322",NA,1,1,0,4,1,0,0,0
"em_5210569",NA,1,1,0,4,1,0,0,0
"em_5154687",NA,1,1,0,4,0,0,0,0
"em_5011793",NA,1,1,0,3,2,0,0,0
"em_5071644",NA,1,1,0,3,0,0,0,0
"em_5255695",NA,1,1,0,3,0,0,0,0
"em_4843356",NA,1,1,0,3,0,0,0,0
"em_5012013",NA,1,1,0,2,1,0,0,0
"em_4884429",NA,1,1,0,2,1,0,0,0
"em_5289320",NA,1,1,0,2,1,0,0,0
"em_5347666",NA,1,1,0,2,1,0,0,0
"em_5200081",NA,1,1,0,2,0,0,0,0
"em_5344629",NA,1,1,0,2,0,0,0,0
"em_5174844",NA,1,1,0,1,1,0,0,0
"em_5174843",NA,1,1,0,1,1,0,0,0
"em_5344635",NA,1,1,0,1,0,0,0,0
"em_5344631",NA,1,1,0,1,0,0,0,0
"em_5314215",NA,1,0,0,167,47,0,0,4
"em_5060000",NA,1,0,0,115,44,0,0,0
"em_5073006",NA,1,0,0,97,0,0,0,0
"em_5200088",NA,1,0,0,94,50,0,0,0
"em_5272376",NA,1,0,0,78,23,0,0,0
"em_4887455",NA,1,0,0,64,20,0,0,1
"em_5218068",NA,1,0,0,54,1,0,0,0
"em_5108363",NA,1,0,0,36,17,0,0,0
"em_5140317",NA,1,0,0,32,1,0,0,1
"em_5174122",NA,1,0,0,32,1,0,0,0
"em_5117137",NA,1,0,0,29,2,0,0,0
"em_5168198",NA,1,0,0,23,3,0,0,0
"em_5302527",NA,1,0,0,22,1,0,0,0
"em_5262642",NA,1,0,0,18,1,0,0,0
"em_4887609",NA,1,0,0,17,1,0,0,0
"em_5050116",NA,1,0,0,17,0,0,0,0
"em_5302535",NA,1,0,0,16,4,0,0,0
"em_4971257",NA,1,0,0,15,5,0,0,0
"em_5235164",NA,1,0,0,14,4,0,0,0
"em_4917899",NA,1,0,0,14,0,0,0,0
"em_5348017",NA,1,0,0,13,2,0,0,0
"em_5110502",NA,1,0,0,13,1,0,0,0
"em_5110436",NA,1,0,0,12,2,0,0,0
"em_5275520",NA,1,0,0,12,1,0,0,0
"em_5120938",NA,1,0,0,12,1,0,0,0
"em_5117482",NA,1,0,0,11,2,0,0,0
"em_4843350",NA,1,0,0,10,0,0,0,0
"em_4967851",NA,1,0,0,8,1,0,0,0
"em_5133857",NA,1,0,0,8,0,0,0,0
"em_5035288",NA,1,0,0,8,0,0,0,0
"em_4970947",NA,1,0,0,8,0,0,0,0
"em_5299307",NA,1,0,0,8,0,0,0,0
"em_5018449",NA,1,0,0,7,0,0,0,0
"em_5079580",NA,1,0,0,7,0,0,0,0
"em_4955137",NA,1,0,0,6,1,0,0,0
"em_5053321",NA,1,0,0,6,0,0,0,0
"em_5113802",NA,1,0,0,6,0,0,0,0
"em_5154681",NA,1,0,0,5,0,0,0,0
"em_5066606",NA,1,0,0,5,0,0,0,0
"em_5275560",NA,1,0,0,5,0,0,0,0
"em_5238839",NA,1,0,0,4,0,0,0,0
"em_4994714",NA,1,0,0,4,0,0,0,0
"em_5015388",NA,1,0,0,4,0,0,0,0
"em_4884319",NA,1,0,0,3,0,0,0,0
"em_5275561",NA,1,0,0,3,0,0,0,0
"em_5011937",NA,1,0,0,3,0,0,0,0
"em_5289315",NA,1,0,0,2,0,0,0,0
"em_4833385",NA,1,0,0,2,0,0,0,0
"em_5162035",NA,1,0,0,2,0,0,0,0
"em_5171926",NA,1,0,0,2,0,0,0,0
"em_5327766",NA,1,0,0,2,0,0,0,0
"em_5099791",NA,1,0,0,2,0,0,0,0
"em_5200079",NA,1,0,0,2,0,0,0,0
"em_5281888",NA,1,0,0,2,0,0,0,0
"em_5113744",NA,1,0,0,2,0,0,0,0
"em_4833264",NA,1,0,0,1,0,0,0,0
"em_5133846",NA,1,0,0,1,0,0,0,0
"em_5200082",NA,1,0,0,1,0,0,0,0
"em_5011934",NA,1,0,0,1,0,0,0,0
"em_5177811",NA,1,0,0,1,0,0,0,0
"em_5174845",NA,1,0,0,1,0,0,0,0
"em_5140314",NA,1,0,0,1,0,0,0,0
"em_4964691",NA,1,0,0,1,0,0,0,0
"em_4848274",NA,1,0,0,1,0,0,0,0
"em_5214215",NA,1,0,0,1,0,0,0,0
"em_5356040",NA,0,0,198,5,3,198,0,0
"em_5356041",NA,0,0,198,5,2,198,0,0
"em_5356043",NA,0,0,198,4,4,198,0,0
"em_5366914",NA,0,0,152,36,11,152,0,0
"em_5366703",NA,0,0,152,13,7,152,0,0
"em_5366740",NA,0,0,152,11,8,152,0,0
"em_5362883",NA,0,0,55,36,23,59,4,0
"em_5357954",NA,0,0,46,5,4,46,0,0
"em_5371941",NA,0,0,36,4,4,43,7,0
"em_5355510",NA,0,0,35,4,4,35,0,0
"em_5359007",NA,0,0,35,2,2,35,0,0
"em_5358997",NA,0,0,35,0,0,35,0,0
"em_5355511",NA,0,0,35,0,0,35,0,0
"em_5366696",NA,0,0,34,1,1,34,0,0
"em_5366982",NA,0,0,34,1,1,34,0,0
"em_5366802",NA,0,0,34,1,1,34,0,0
"em_5366705",NA,0,0,34,1,1,34,0,0
"em_5359003",NA,0,0,33,1,1,33,0,0
"em_5370504",NA,0,0,29,3,2,29,0,0
"em_5359300",NA,0,0,27,4,3,27,0,0
"em_5355613",NA,0,0,26,6,2,27,1,0
"em_5355614",NA,0,0,26,4,3,27,1,0
"em_5358986",NA,0,0,26,3,2,27,1,0
"em_5362935",NA,0,0,26,2,2,27,1,0
"em_5362881",NA,0,0,26,2,2,27,1,0
"em_5355559",NA,0,0,26,1,1,27,1,0
"em_5366653",NA,0,0,26,1,1,26,0,0
"em_5370533",NA,0,0,26,1,1,26,0,0
"em_5366657",NA,0,0,26,1,1,26,0,0
"em_5355514",NA,0,0,26,0,0,27,1,0
"em_5370534",NA,0,0,26,0,0,26,0,0
"em_5370506",NA,0,0,26,0,0,26,0,0
"em_5370505",NA,0,0,26,0,0,26,0,0
"em_5365959",NA,0,0,24,4,2,24,0,0
"em_5365963",NA,0,0,24,2,2,24,0,0
"em_5367219",NA,0,0,24,2,1,24,0,0
"em_5367417",NA,0,0,24,2,1,24,0,0
"em_5365969",NA,0,0,24,2,1,24,0,0
"em_5365964",NA,0,0,24,1,1,24,0,0
"em_5371148",NA,0,0,24,0,0,24,0,0
"em_5365966",NA,0,0,24,0,0,24,0,0
"em_5359462",NA,0,0,21,5,5,27,6,0
"em_5370381",NA,0,0,18,224,11,18,0,0
"em_5369796",NA,0,0,12,150,9,12,0,0
"em_5368855",NA,0,0,8,4,2,8,0,0
"em_5362872",NA,0,0,8,4,2,8,0,0
"em_5362940",NA,0,0,8,4,2,8,0,0
"em_5362925",NA,0,0,8,3,2,8,0,0
"em_5362879",NA,0,0,8,2,2,8,0,0
"em_5362873",NA,0,0,8,1,1,8,0,0
"em_5362876",NA,0,0,8,1,1,8,0,0
"em_5362877",NA,0,0,8,1,1,8,0,0
"em_5362874",NA,0,0,8,1,1,8,0,0
"em_5355309",NA,0,0,1,28,1,1,0,0
"em_5355302",NA,0,0,1,28,1,1,0,0
"em_5355755",NA,0,0,1,27,1,1,0,0
"em_5355303",NA,0,0,1,26,1,1,0,0
"em_5355507",NA,0,0,1,25,1,1,0,0
"em_5369799",NA,0,0,1,24,1,1,0,0
"em_5355556",NA,0,0,1,24,1,1,0,0
"em_5355245",NA,0,0,1,24,1,1,0,0
"em_5370337",NA,0,0,1,24,1,1,0,0
"em_5357897",NA,0,0,1,23,1,1,0,0
"em_5355307",NA,0,0,1,23,1,1,0,0
"em_5355503",NA,0,0,1,22,1,1,0,0
"em_5366407",NA,0,0,1,22,1,1,0,0
"em_5369608",NA,0,0,1,3,1,1,0,0
"em_5366860",NA,0,0,1,1,1,1,0,0
"em_5366369",NA,0,0,1,1,1,1,0,0
"em_5358639",NA,0,0,1,0,0,1,0,0
"em_5370217",NA,0,0,1,0,0,1,0,0
"em_5044315",NA,0,0,0,181,79,0,0,3
"em_5125919",NA,0,0,0,171,72,0,0,1
"em_5036873",NA,0,0,0,130,58,0,0,0
"em_5059724",NA,0,0,0,126,75,0,0,2
"em_5020581",NA,0,0,0,121,40,0,0,1
"em_5086715",NA,0,0,0,107,18,0,0,0
"em_4859125",NA,0,0,0,78,30,0,0,1
"em_5038559",NA,0,0,0,73,28,0,0,2
"em_5040003",NA,0,0,0,56,11,0,0,0
"em_4837440",NA,0,0,0,51,26,0,0,1
"em_5074928",NA,0,0,0,51,19,0,0,0
"em_4941341",NA,0,0,0,51,17,0,0,0
"em_5231605",NA,0,0,0,49,9,0,0,0
"em_5333432",NA,0,0,0,48,16,0,0,0
"em_4851253",NA,0,0,0,46,25,0,0,2
"em_4855526",NA,0,0,0,45,16,0,0,0
"em_5310548",NA,0,0,0,42,18,0,0,1
"em_5149581",NA,0,0,0,41,19,0,0,0
"em_4941326",NA,0,0,0,40,13,0,0,0
"em_5289316",NA,0,0,0,39,13,0,0,0
"em_4916435",NA,0,0,0,38,22,0,0,1
"em_4851247",NA,0,0,0,35,20,0,0,0
"em_4836117",NA,0,0,0,35,17,0,0,0
"em_5090599",NA,0,0,0,32,0,0,0,0
"em_4903460",NA,0,0,0,30,9,0,0,0
"em_5275572",NA,0,0,0,29,8,0,0,0
"em_5110504",NA,0,0,0,29,6,0,0,0
"em_4842385",NA,0,0,0,28,19,0,0,0
"em_4887827",NA,0,0,0,27,1,0,0,0
"em_4994663",NA,0,0,0,26,1,0,0,0
"em_5072081",NA,0,0,0,25,10,0,0,1
"em_4992145",NA,0,0,0,25,6,0,0,0
"em_4984564",NA,0,0,0,25,0,0,0,0
"em_5015325",NA,0,0,0,25,0,0,0,0
"em_5248651",NA,0,0,0,24,12,0,0,1
"em_5292716",NA,0,0,0,24,1,0,0,0
"em_4884618",NA,0,0,0,23,11,0,0,0
"em_5220772",NA,0,0,0,23,0,0,0,0
"em_5094049",NA,0,0,0,22,17,0,0,0
"em_5249319",NA,0,0,0,22,6,0,0,0
"em_5137470",NA,0,0,0,22,1,0,0,0
"em_5171473",NA,0,0,0,21,5,0,0,0
"em_5027111",NA,0,0,0,20,10,0,0,0
"em_4836118",NA,0,0,0,20,9,0,0,0
"em_5272344",NA,0,0,0,20,7,0,0,0
"em_5310547",NA,0,0,0,20,4,0,0,0
"em_5096352",NA,0,0,0,19,0,0,0,0
"em_4878827",NA,0,0,0,18,9,0,0,1
"em_5231586",NA,0,0,0,17,4,0,0,0
"em_5158265",NA,0,0,0,16,4,0,0,0
"em_4927950",NA,0,0,0,16,0,0,0,0
"em_5262334",NA,0,0,0,16,0,0,0,0
"em_5151624",NA,0,0,0,15,7,0,0,0
"em_4986269",NA,0,0,0,15,7,0,0,0
"em_4884604",NA,0,0,0,15,7,0,0,0
"em_5088118",NA,0,0,0,15,6,0,0,0
"em_4884623",NA,0,0,0,15,4,0,0,0
"em_4917900",NA,0,0,0,15,1,0,0,0
"em_5129261",NA,0,0,0,15,0,0,0,0
"em_5147516",NA,0,0,0,14,7,0,0,0
"em_5317996",NA,0,0,0,14,3,0,0,0
"em_5168204",NA,0,0,0,14,2,0,0,0
"em_4830003",NA,0,0,0,14,0,0,0,0
"em_4897360",NA,0,0,0,14,0,0,0,0
"em_4965996",NA,0,0,0,13,7,0,0,0
"em_4884622",NA,0,0,0,13,3,0,0,0
"em_5161392",NA,0,0,0,13,1,0,0,0
"em_5275849",NA,0,0,0,13,1,0,0,0
"em_5088119",NA,0,0,0,12,6,0,0,0
"em_4927932",NA,0,0,0,12,2,0,0,0
"em_4954970",NA,0,0,0,12,1,0,0,0
"em_5282493",NA,0,0,0,12,0,0,0,0
"em_4866830",NA,0,0,0,12,0,0,0,0
"em_4833220",NA,0,0,0,11,6,0,0,0
"em_5317991",NA,0,0,0,11,5,0,0,0
"em_5079597",NA,0,0,0,11,3,0,0,0
"em_5055985",NA,0,0,0,11,2,0,0,0
"em_5190806",NA,0,0,0,11,2,0,0,0
"em_5089799",NA,0,0,0,11,2,0,0,0
"em_5046853",NA,0,0,0,11,1,0,0,0
"em_5086674",NA,0,0,0,11,0,0,0,0
"em_5018331",NA,0,0,0,11,0,0,0,0
"em_4977608",NA,0,0,0,10,3,0,0,0
"em_4855584",NA,0,0,0,10,3,0,0,0
"em_4934733",NA,0,0,0,10,2,0,0,0
"em_5140980",NA,0,0,0,10,2,0,0,0
"em_4897666",NA,0,0,0,10,1,0,0,0
"em_4856218",NA,0,0,0,10,1,0,0,0
"em_5214223",NA,0,0,0,10,0,0,0,0
"em_5037443",NA,0,0,0,10,0,0,0,0
"em_5174128",NA,0,0,0,10,0,0,0,0
"em_4939712",NA,0,0,0,9,6,0,0,0
"em_5174846",NA,0,0,0,9,5,0,0,0
"em_5015141",NA,0,0,0,9,5,0,0,0
"em_4939711",NA,0,0,0,9,4,0,0,0
"em_5105181",NA,0,0,0,9,4,0,0,0
"em_4926059",NA,0,0,0,9,3,0,0,0
"em_4944901",NA,0,0,0,9,1,0,0,0
"em_4937802",NA,0,0,0,9,1,0,0,0
"em_5038545",NA,0,0,0,9,0,0,0,0
"em_5220763",NA,0,0,0,9,0,0,0,0
"em_4877397",NA,0,0,0,9,0,0,0,0
"em_5003229",NA,0,0,0,8,5,0,0,0
"em_4983109",NA,0,0,0,8,4,0,0,0
"em_5130559",NA,0,0,0,8,3,0,0,0
"em_5070062",NA,0,0,0,8,2,0,0,0
"em_5099792",NA,0,0,0,8,2,0,0,0
"em_4836875",NA,0,0,0,8,1,0,0,0
"em_4852146",NA,0,0,0,8,1,0,0,0
"em_4955204",NA,0,0,0,8,1,0,0,0
"em_5140978",NA,0,0,0,8,0,0,0,0
"em_4914669",NA,0,0,0,8,0,0,0,0
"em_5252258",NA,0,0,0,7,3,0,0,0
"em_4967787",NA,0,0,0,7,2,0,0,0
"em_5194149",NA,0,0,0,7,2,0,0,0
"em_5174129",NA,0,0,0,7,1,0,0,0
"em_4846355",NA,0,0,0,7,1,0,0,0
"em_4957975",NA,0,0,0,7,0,0,0,0
"em_5076276",NA,0,0,0,7,0,0,0,0
"em_4906276",NA,0,0,0,6,5,0,0,0
"em_4861400",NA,0,0,0,6,4,0,0,0
"em_4967800",NA,0,0,0,6,2,0,0,0
"em_5053326",NA,0,0,0,6,1,0,0,0
"em_4934516",NA,0,0,0,6,1,0,0,0
"em_5086683",NA,0,0,0,6,1,0,0,0
"em_5177766",NA,0,0,0,6,1,0,0,0
"em_4908207",NA,0,0,0,6,1,0,0,0
"em_5028835",NA,0,0,0,6,0,0,0,0
"em_5158260",NA,0,0,0,6,0,0,0,0
"em_5214229",NA,0,0,0,6,0,0,0,0
"em_5008741",NA,0,0,0,6,0,0,0,0
"em_5325137",NA,0,0,0,6,0,0,0,0
"em_5008678",NA,0,0,0,6,0,0,0,0
"em_4948303",NA,0,0,0,6,0,0,0,0
"em_5264581",NA,0,0,0,6,0,0,0,0
"em_4954973",NA,0,0,0,6,0,0,0,0
"em_5090608",NA,0,0,0,5,3,0,0,0
"em_5078178",NA,0,0,0,5,3,0,0,0
"em_4984736",NA,0,0,0,5,1,0,0,0
"em_4948318",NA,0,0,0,5,1,0,0,0
"em_4977616",NA,0,0,0,5,1,0,0,0
"em_5200620",NA,0,0,0,5,1,0,0,0
"em_4887597",NA,0,0,0,5,1,0,0,0
"em_4977596",NA,0,0,0,5,1,0,0,0
"em_5241537",NA,0,0,0,5,1,0,0,0
"em_5117196",NA,0,0,0,5,0,0,0,0
"em_4987995",NA,0,0,0,5,0,0,0,0
"em_5238584",NA,0,0,0,5,0,0,0,0
"em_4870383",NA,0,0,0,5,0,0,0,0
"em_5025617",NA,0,0,0,5,0,0,0,0
"em_5158263",NA,0,0,0,5,0,0,0,0
"em_5096415",NA,0,0,0,5,0,0,0,0
"em_4998179",NA,0,0,0,5,0,0,0,0
"em_5008754",NA,0,0,0,5,0,0,0,0
"em_4930545",NA,0,0,0,5,0,0,0,0
"em_5171407",NA,0,0,0,5,0,0,0,0
"em_5032234",NA,0,0,0,5,0,0,0,0
"em_5259138",NA,0,0,0,5,0,0,0,0
"em_5086065",NA,0,0,0,4,2,0,0,0
"em_4861401",NA,0,0,0,4,2,0,0,0
"em_5024010",NA,0,0,0,4,2,0,0,0
"em_5333424",NA,0,0,0,4,2,0,0,0
"em_4991289",NA,0,0,0,4,1,0,0,0
"em_5200089",NA,0,0,0,4,1,0,0,0
"em_5113810",NA,0,0,0,4,1,0,0,0
"em_5321869",NA,0,0,0,4,1,0,0,0
"em_4937841",NA,0,0,0,4,1,0,0,0
"em_4849758",NA,0,0,0,4,1,0,0,0
"em_4998185",NA,0,0,0,4,1,0,0,0
"em_4887536",NA,0,0,0,4,1,0,0,0
"em_5032329",NA,0,0,0,4,1,0,0,0
"em_4944914",NA,0,0,0,4,0,0,0,0
"em_5072998",NA,0,0,0,4,0,0,0,0
"em_5237518",NA,0,0,0,4,0,0,0,0
"em_5327909",NA,0,0,0,4,0,0,0,0
"em_4856217",NA,0,0,0,4,0,0,0,0
"em_5059670",NA,0,0,0,4,0,0,0,0
"em_5189974",NA,0,0,0,4,0,0,0,0
"em_4886188",NA,0,0,0,4,0,0,0,0
"em_5096535",NA,0,0,0,4,0,0,0,0
"em_4996651",NA,0,0,0,4,0,0,0,0
"em_5079586",NA,0,0,0,4,0,0,0,0
"em_5093134",NA,0,0,0,4,0,0,0,0
"em_5096429",NA,0,0,0,4,0,0,0,0
"em_5348102",NA,0,0,0,3,3,0,0,0
"em_4877407",NA,0,0,0,3,3,0,0,0
"em_4924151",NA,0,0,0,3,2,0,0,0
"em_5154703",NA,0,0,0,3,2,0,0,0
"em_5089742",NA,0,0,0,3,2,0,0,0
"em_4873925",NA,0,0,0,3,2,0,0,0
"em_4846309",NA,0,0,0,3,2,0,0,0
"em_5086066",NA,0,0,0,3,2,0,0,0
"em_5167937",NA,0,0,0,3,1,0,0,0
"em_4948253",NA,0,0,0,3,1,0,0,0
"em_4824424",NA,0,0,0,3,1,0,0,0
"em_5194160",NA,0,0,0,3,1,0,0,0
"em_5275522",NA,0,0,0,3,1,0,0,0
"em_4856224",NA,0,0,0,3,1,0,0,0
"em_4873870",NA,0,0,0,3,1,0,0,0
"em_5066540",NA,0,0,0,3,1,0,0,0
"em_5337625",NA,0,0,0,3,1,0,0,0
"em_5053343",NA,0,0,0,3,1,0,0,0
"em_4951677",NA,0,0,0,3,0,0,0,0
"em_4934573",NA,0,0,0,3,0,0,0,0
"em_5210521",NA,0,0,0,3,0,0,0,0
"em_5187653",NA,0,0,0,3,0,0,0,0
"em_5056494",NA,0,0,0,3,0,0,0,0
"em_4927961",NA,0,0,0,3,0,0,0,0
"em_4988004",NA,0,0,0,3,0,0,0,0
"em_5348278",NA,0,0,0,3,0,0,0,0
"em_5133848",NA,0,0,0,3,0,0,0,0
"em_4914724",NA,0,0,0,3,0,0,0,0
"em_5059699",NA,0,0,0,3,0,0,0,0
"em_5174189",NA,0,0,0,3,0,0,0,0
"em_5113818",NA,0,0,0,3,0,0,0,0
"em_5079594",NA,0,0,0,3,0,0,0,0
"em_5140981",NA,0,0,0,3,0,0,0,0
"em_5093081",NA,0,0,0,3,0,0,0,0
"em_4897350",NA,0,0,0,3,0,0,0,0
"em_5347718",NA,0,0,0,3,0,0,0,0
"em_4994718",NA,0,0,0,3,0,0,0,0
"em_4958027",NA,0,0,0,3,0,0,0,0
"em_4970785",NA,0,0,0,3,0,0,0,0
"em_4897715",NA,0,0,0,3,0,0,0,0
"em_5018495",NA,0,0,0,3,0,0,0,0
"em_5255874",NA,0,0,0,3,0,0,0,0
"em_4877406",NA,0,0,0,3,0,0,0,0
"em_5015383",NA,0,0,0,3,0,0,0,0
"em_4882642",NA,0,0,0,3,0,0,0,0
"em_5344019",NA,0,0,0,2,2,0,0,0
"em_5168383",NA,0,0,0,2,1,0,0,0
"em_5235453",NA,0,0,0,2,1,0,0,0
"em_4894006",NA,0,0,0,2,1,0,0,0
"em_4833640",NA,0,0,0,2,1,0,0,0
"em_4856222",NA,0,0,0,2,1,0,0,0
"em_4852137",NA,0,0,0,2,1,0,0,0
"em_5317995",NA,0,0,0,2,1,0,0,0
"em_5151612",NA,0,0,0,2,1,0,0,0
"em_5248777",NA,0,0,0,2,1,0,0,0
"em_4934732",NA,0,0,0,2,1,0,0,0
"em_4964984",NA,0,0,0,2,1,0,0,0
"em_5241658",NA,0,0,0,2,1,0,0,0
"em_5014687",NA,0,0,0,2,1,0,0,0
"em_4908256",NA,0,0,0,2,1,0,0,0
"em_5269305",NA,0,0,0,2,1,0,0,0
"em_5167936",NA,0,0,0,2,1,0,0,0
"em_5133849",NA,0,0,0,2,0,0,0,0
"em_5140990",NA,0,0,0,2,0,0,0,0
"em_4946855",NA,0,0,0,2,0,0,0,0
"em_5117202",NA,0,0,0,2,0,0,0,0
"em_5076277",NA,0,0,0,2,0,0,0,0
"em_4894276",NA,0,0,0,2,0,0,0,0
"em_5113797",NA,0,0,0,2,0,0,0,0
"em_5228212",NA,0,0,0,2,0,0,0,0
"em_5059750",NA,0,0,0,2,0,0,0,0
"em_5028819",NA,0,0,0,2,0,0,0,0
"em_5234098",NA,0,0,0,2,0,0,0,0
"em_4890920",NA,0,0,0,2,0,0,0,0
"em_5296252",NA,0,0,0,2,0,0,0,0
"em_4984779",NA,0,0,0,2,0,0,0,0
"em_5154685",NA,0,0,0,2,0,0,0,0
"em_5059752",NA,0,0,0,2,0,0,0,0
"em_4897452",NA,0,0,0,2,0,0,0,0
"em_5213400",NA,0,0,0,2,0,0,0,0
"em_4979250",NA,0,0,0,2,0,0,0,0
"em_5053341",NA,0,0,0,2,0,0,0,0
"em_5032212",NA,0,0,0,2,0,0,0,0
"em_4991353",NA,0,0,0,2,0,0,0,0
"em_5214311",NA,0,0,0,2,0,0,0,0
"em_4873919",NA,0,0,0,2,0,0,0,0
"em_4958024",NA,0,0,0,2,0,0,0,0
"em_5093053",NA,0,0,0,2,0,0,0,0
"em_5137481",NA,0,0,0,2,0,0,0,0
"em_4852945",NA,0,0,0,2,0,0,0,0
"em_5035354",NA,0,0,0,2,0,0,0,0
"em_4937840",NA,0,0,0,2,0,0,0,0
"em_4991361",NA,0,0,0,2,0,0,0,0
"em_4987975",NA,0,0,0,2,0,0,0,0
"em_5059705",NA,0,0,0,2,0,0,0,0
"em_4904883",NA,0,0,0,2,0,0,0,0
"em_5289310",NA,0,0,0,2,0,0,0,0
"em_4911551",NA,0,0,0,2,0,0,0,0
"em_5005494",NA,0,0,0,2,0,0,0,0
"em_4836876",NA,0,0,0,2,0,0,0,0
"em_5174185",NA,0,0,0,2,0,0,0,0
"em_5180770",NA,0,0,0,2,0,0,0,0
"em_5011928",NA,0,0,0,2,0,0,0,0
"em_5093171",NA,0,0,0,2,0,0,0,0
"em_4955122",NA,0,0,0,2,0,0,0,0
"em_5038651",NA,0,0,0,1,1,0,0,0
"em_4870443",NA,0,0,0,1,1,0,0,0
"em_4964197",NA,0,0,0,1,1,0,0,0
"em_4833438",NA,0,0,0,1,1,0,0,0
"em_4893667",NA,0,0,0,1,1,0,0,0
"em_5255706",NA,0,0,0,1,1,0,0,0
"em_4977620",NA,0,0,0,1,1,0,0,0
"em_5197158",NA,0,0,0,1,1,0,0,0
"em_4894320",NA,0,0,0,1,1,0,0,0
"em_4903096",NA,0,0,0,1,1,0,0,0
"em_4990712",NA,0,0,0,1,1,0,0,0
"em_4863345",NA,0,0,0,1,1,0,0,0
"em_4991504",NA,0,0,0,1,1,0,0,0
"em_4856363",NA,0,0,0,1,1,0,0,0
"em_5194150",NA,0,0,0,1,1,0,0,0
"em_4913094",NA,0,0,0,1,1,0,0,0
"em_5269250",NA,0,0,0,1,1,0,0,0
"em_4964852",NA,0,0,0,1,1,0,0,0
"em_5120931",NA,0,0,0,1,1,0,0,0
"em_5262369",NA,0,0,0,1,1,0,0,0
"em_5347717",NA,0,0,0,1,1,0,0,0
"em_4998184",NA,0,0,0,1,0,0,0,0
"em_4870403",NA,0,0,0,1,0,0,0,0
"em_5076270",NA,0,0,0,1,0,0,0,0
"em_4849770",NA,0,0,0,1,0,0,0,0
"em_4863360",NA,0,0,0,1,0,0,0,0
"em_5293242",NA,0,0,0,1,0,0,0,0
"em_5037999",NA,0,0,0,1,0,0,0,0
"em_4897714",NA,0,0,0,1,0,0,0,0
"em_5292717",NA,0,0,0,1,0,0,0,0
"em_4934789",NA,0,0,0,1,0,0,0,0
"em_5073978",NA,0,0,0,1,0,0,0,0
"em_4866764",NA,0,0,0,1,0,0,0,0
"em_5303089",NA,0,0,0,1,0,0,0,0
"em_5348248",NA,0,0,0,1,0,0,0,0
"em_4917918",NA,0,0,0,1,0,0,0,0
"em_5113812",NA,0,0,0,1,0,0,0,0
"em_5032229",NA,0,0,0,1,0,0,0,0
"em_4836884",NA,0,0,0,1,0,0,0,0
"em_5161391",NA,0,0,0,1,0,0,0,0
"em_5200080",NA,0,0,0,1,0,0,0,0
"em_5093087",NA,0,0,0,1,0,0,0,0
"em_4823444",NA,0,0,0,1,0,0,0,0
"em_5235448",NA,0,0,0,1,0,0,0,0
"em_5096427",NA,0,0,0,1,0,0,0,0
"em_5127559",NA,0,0,0,1,0,0,0,0
"em_5347608",NA,0,0,0,1,0,0,0,0
"em_4911372",NA,0,0,0,1,0,0,0,0
"em_5133843",NA,0,0,0,1,0,0,0,0
"em_5180771",NA,0,0,0,1,0,0,0,0
"em_5174131",NA,0,0,0,1,0,0,0,0
"em_5086063",NA,0,0,0,1,0,0,0,0
"em_4924787",NA,0,0,0,1,0,0,0,0
"em_4937572",NA,0,0,0,1,0,0,0,0
"em_4944568",NA,0,0,0,1,0,0,0,0
"em_4970792",NA,0,0,0,1,0,0,0,0
"em_5015686",NA,0,0,0,1,0,0,0,0
"em_4970926",NA,0,0,0,1,0,0,0,0
"em_4826477",NA,0,0,0,1,0,0,0,0
"em_5262501",NA,0,0,0,1,0,0,0,0
"em_5100011",NA,0,0,0,1,0,0,0,0
"em_4836882",NA,0,0,0,1,0,0,0,0
"em_5096426",NA,0,0,0,1,0,0,0,0
"em_5344252",NA,0,0,0,1,0,0,0,0
"em_4997381",NA,0,0,0,1,0,0,0,0
"em_5032338",NA,0,0,0,1,0,0,0,0
"em_5317993",NA,0,0,0,1,0,0,0,0
"em_4890822",NA,0,0,0,1,0,0,0,0
"em_5170901",NA,0,0,0,1,0,0,0,0
"em_5200612",NA,0,0,0,1,0,0,0,0
"em_5302432",NA,0,0,0,1,0,0,0,0
"em_5011933",NA,0,0,0,1,0,0,0,0
"em_4948317",NA,0,0,0,1,0,0,0,0
"em_5044314",NA,0,0,0,1,0,0,0,0
"em_5347781",NA,0,0,0,1,0,0,0,0
"em_5154695",NA,0,0,0,1,0,0,0,0
"em_4917924",NA,0,0,0,1,0,0,0,0
"em_4931269",NA,0,0,0,1,0,0,0,0
"em_5302433",NA,0,0,0,1,0,0,0,0
"em_5066553",NA,0,0,0,1,0,0,0,0
"em_4974245",NA,0,0,0,1,0,0,0,0
"em_4911600",NA,0,0,0,1,0,0,0,0
"em_5205006",NA,0,0,0,1,0,0,0,0
"em_4890980",NA,0,0,0,1,0,0,0,0
"em_5160148",NA,0,0,0,1,0,0,0,0
"em_4823147",NA,0,0,0,1,0,0,0,0
"em_5243052",NA,0,0,0,1,0,0,0,0
"em_4994727",NA,0,0,0,1,0,0,0,0
"em_5275279",NA,0,0,0,1,0,0,0,0
"em_5280687",NA,0,0,0,1,0,0,0,0
"em_5154686",NA,0,0,0,1,0,0,0,0
"em_5121309",NA,0,0,0,1,0,0,0,0
"em_4991300",NA,0,0,0,1,0,0,0,0
"em_5133842",NA,0,0,0,1,0,0,0,0
"em_5133864",NA,0,0,0,1,0,0,0,0
"em_5347696",NA,0,0,0,1,0,0,0,0
"em_4914725",NA,0,0,0,1,0,0,0,0
"em_4822883",NA,0,0,0,1,0,0,0,0
"em_5161984",NA,0,0,0,1,0,0,0,0
"em_5344370",NA,0,0,0,1,0,0,0,0
"em_5035337",NA,0,0,0,1,0,0,0,0
"em_5344687",NA,0,0,0,1,0,0,0,0
"em_4914718",NA,0,0,0,1,0,0,0,0
"em_5059751",NA,0,0,0,1,0,0,0,0
"em_5153175",NA,0,0,0,1,0,0,0,0
"em_5258804",NA,0,0,0,1,0,0,0,0
"em_4944900",NA,0,0,0,1,0,0,0,0
"em_5323911",NA,0,0,0,1,0,0,0,0
"em_5180827",NA,0,0,0,1,0,0,0,0
"em_5201256",NA,0,0,0,1,0,0,0,0
"em_5099756",NA,0,0,0,1,0,0,0,0
"em_5059999",NA,0,0,0,1,0,0,0,0
"em_4974221",NA,0,0,0,1,0,0,0,0
"em_4934521",NA,0,0,0,1,0,0,0,0
"em_5154630",NA,0,0,0,1,0,0,0,0
"em_5186946",NA,0,0,-1,14,7,0,1,0
"em_4967879",NA,0,0,-2,120,62,0,2,1
"em_4977650",NA,2012,1166,-137,8156,2426,0,137,3
"em_5374697",NA,1188,650,2595,2932,1418,2615,20,0
"em_5372031",NA,1113,647,2282,3021,1405,2302,20,0
"em_5354452",NA,991,734,6997,4758,2879,7082,85,43
"em_5349469",NA,634,199,-2,1532,198,0,2,0
"em_5351877",NA,590,193,-2,1586,204,0,2,0
"em_5370942",NA,589,460,6847,4837,3211,6880,33,28
"em_5357566",NA,582,334,1838,2223,955,1871,33,2
"em_5365474",NA,525,285,1678,1813,772,1688,10,1
"em_5354348",NA,507,200,563,1107,386,565,2,0
"em_5354294",NA,484,246,1163,1726,612,1183,20,0
"em_5374681",NA,426,241,1362,1168,650,1367,5,0
"em_5361593",NA,423,205,1072,1173,537,1081,9,1
"em_5354431",NA,411,275,3090,1806,1125,3125,35,7
"em_5369208",NA,320,172,1034,995,477,1040,6,0
"em_5369178",NA,306,171,1041,1163,516,1042,1,0
"em_5351860",NA,300,109,-3,928,169,0,3,0
"em_5365503",NA,272,147,596,840,362,604,8,0
"em_5354323",NA,247,120,528,598,270,535,7,0
"em_5371971",NA,230,157,1006,960,486,1008,2,2
"em_5357554",NA,210,116,461,577,275,465,4,0
"em_5346524",NA,172,48,-4,408,67,0,4,0
"em_5361617",NA,170,90,425,450,220,429,4,0
"em_5342701",NA,125,33,0,260,36,0,0,0
"em_5346595",NA,119,30,0,203,26,0,0,0
"em_5331823",NA,118,23,0,283,29,0,0,0
"em_5304437",NA,107,15,0,122,11,0,0,0
"em_5365412",NA,105,62,307,333,155,309,2,1
"em_5369234",NA,105,44,181,299,108,182,1,0
"em_5349425",NA,96,35,-3,383,67,0,3,0
"em_5349457",NA,95,39,0,273,56,0,0,0
"em_5320520",NA,94,21,0,205,22,0,0,0
"em_5324480",NA,94,18,0,149,14,0,0,1
"em_5357584",NA,93,51,284,318,150,289,5,0
"em_5348130",NA,85,49,-16,668,219,0,16,3
"em_5301330",NA,77,14,0,150,15,0,0,0
"em_5298200",NA,74,21,0,133,13,0,0,0
"em_5346285",NA,60,24,-5,299,48,0,5,0
"em_5361583",NA,54,21,68,111,40,68,0,0
"em_5374677",NA,49,36,201,188,91,201,0,0
"em_5230373",NA,48,6,0,65,3,0,0,0
"em_5339449",NA,47,18,0,239,24,0,0,0
"em_5329199",NA,46,8,0,122,13,0,0,0
"em_5372014",NA,42,24,136,111,55,136,0,0
"em_5285853",NA,38,10,0,54,3,0,0,0
"em_5351856",NA,36,11,0,100,17,0,0,0
"em_5346373",NA,36,11,-2,257,30,0,2,1
"em_5361576",NA,35,20,123,119,57,124,1,0
"em_5335895",NA,35,9,0,122,11,0,0,0
"em_5374685",NA,33,17,161,132,70,162,1,0
"em_5349439",NA,33,16,-2,98,21,0,2,0
"em_5325471",NA,33,15,0,271,48,0,0,1
"em_5342679",NA,33,11,0,84,11,0,0,0
"em_5216503",NA,31,8,0,32,3,0,0,0
"em_5306442",NA,31,6,0,97,11,0,0,1
"em_5309345",NA,31,6,0,82,4,0,0,0
"em_5291439",NA,29,10,0,117,7,0,0,0
"em_5301045",NA,29,6,0,100,6,0,0,0
"em_5280712",NA,29,6,0,96,10,0,0,0
"em_5283837",NA,27,9,0,113,6,0,0,0
"em_5326908",NA,26,8,0,128,9,0,0,0
"em_5122499",NA,26,5,0,56,5,0,0,0
"em_5222501",NA,26,5,0,50,8,0,0,0
"em_5329221",NA,26,4,0,36,4,0,0,0
"em_5212933",NA,26,0,0,57,1,0,0,0
"em_5374682",NA,25,14,107,60,33,108,1,0
"em_5331828",NA,24,18,0,217,73,0,0,1
"em_5369182",NA,23,14,58,69,25,58,0,0
"em_5316727",NA,23,5,0,58,4,0,0,0
"em_5277909",NA,22,8,0,80,13,0,0,0
"em_5335871",NA,22,7,0,53,6,0,0,0
"em_5313548",NA,22,5,0,45,6,0,0,0
"em_5233882",NA,21,5,0,39,5,0,0,0
"em_5222523",NA,21,1,0,60,3,0,0,0
"em_5365451",NA,20,15,97,76,44,97,0,0
"em_5331926",NA,20,5,0,64,5,0,0,0
"em_5061400",NA,20,4,0,46,2,0,0,0
"em_5267973",NA,20,2,0,47,4,0,0,0
"em_5081326",NA,20,0,0,46,0,0,0,0
"em_5287833",NA,19,4,0,46,3,0,0,0
"em_5291355",NA,18,4,0,71,2,0,0,0
"em_5295002",NA,17,10,0,43,7,0,0,0
"em_5342654",NA,17,6,0,79,5,0,0,0
"em_5301135",NA,16,4,0,51,2,0,0,0
"em_5182487",NA,16,1,0,44,4,0,0,0
"em_5304119",NA,15,5,0,61,6,0,0,0
"em_5335917",NA,15,5,0,31,3,0,0,0
"em_5313481",NA,15,3,0,61,3,0,0,0
"em_5243229",NA,14,5,0,66,4,0,0,0
"em_5261083",NA,14,4,0,32,2,0,0,0
"em_5283954",NA,14,3,0,27,4,0,0,0
"em_5254500",NA,14,2,0,39,3,0,0,0
"em_5266009",NA,14,1,0,68,3,0,0,0
"em_5162777",NA,13,4,0,36,3,0,0,0
"em_5144876",NA,13,2,0,42,2,0,0,0
"em_5129525",NA,13,2,0,29,1,0,0,0
"em_5357595",NA,12,4,14,18,9,14,0,0
"em_5209518",NA,12,4,0,30,1,0,0,0
"em_5326927",NA,12,1,0,55,4,0,0,0
"em_5331843",NA,12,1,0,34,7,0,0,0
"em_5124413",NA,12,1,0,26,1,0,0,0
"em_5280617",NA,11,5,0,56,5,0,0,0
"em_5222556",NA,10,1,0,21,2,0,0,0
"em_5058623",NA,10,0,0,23,1,0,0,0
"em_5331807",NA,9,6,0,74,34,0,0,1
"em_5282494",NA,9,5,0,100,13,0,0,1
"em_5258030",NA,9,5,0,25,2,0,0,0
"em_5323878",NA,9,4,0,67,5,0,0,0
"em_5245312",NA,9,3,0,28,0,0,0,0
"em_5306532",NA,9,2,0,65,4,0,0,0
"em_5105934",NA,9,1,0,38,1,0,0,0
"em_5193028",NA,9,1,0,5,0,0,0,0
"em_5264044",NA,8,3,0,29,2,0,0,0
"em_5162754",NA,8,3,0,28,1,0,0,0
"em_5166852",NA,8,3,0,25,1,0,0,0
"em_5103778",NA,8,2,0,36,4,0,0,0
"em_5285835",NA,8,2,0,19,1,0,0,0
"em_5126758",NA,8,1,0,20,0,0,0,0
"em_5204142",NA,8,1,0,19,1,0,0,0
"em_5291548",NA,8,0,0,47,1,0,0,0
"em_5209477",NA,8,0,0,16,1,0,0,0
"em_5331824",NA,8,0,0,4,0,0,0,0
"em_5020274",NA,7,2,0,29,4,0,0,0
"em_5366775",NA,7,1,1,16,1,1,0,0
"em_5101853",NA,7,1,0,41,3,0,0,0
"em_5271394",NA,7,1,0,38,7,0,0,0
"em_5316707",NA,7,1,0,20,5,0,0,0
"em_5196356",NA,7,1,0,14,0,0,0,0
"em_5182455",NA,7,0,0,39,5,0,0,0
"em_5199479",NA,7,0,0,6,0,0,0,0
"em_5040228",NA,6,2,0,37,2,0,0,0
"em_5294760",NA,6,2,0,23,1,0,0,0
"em_5199331",NA,6,2,0,13,1,0,0,0
"em_5184403",NA,6,2,0,12,1,0,0,0
"em_5266047",NA,6,2,0,3,0,0,0,0
"em_5017508",NA,6,1,0,25,2,0,0,0
"em_5098626",NA,6,1,0,25,0,0,0,0
"em_5274467",NA,6,1,0,16,0,0,0,0
"em_5042219",NA,6,1,0,12,1,0,0,0
"em_5037483",NA,6,1,0,12,0,0,0,0
"em_5078467",NA,6,1,0,6,2,0,0,0
"em_5179792",NA,6,0,0,33,0,0,0,0
"em_5147195",NA,6,0,0,25,2,0,0,0
"em_5202101",NA,6,0,0,23,2,0,0,0
"em_5254388",NA,6,0,0,20,0,0,0,0
"em_5224647",NA,6,0,0,19,1,0,0,0
"em_5212852",NA,6,0,0,11,0,0,0,0
"em_5329198",NA,5,3,0,45,8,0,0,0
"em_5267889",NA,5,2,0,55,12,0,0,0
"em_5204165",NA,5,2,0,29,1,0,0,0
"em_5240437",NA,5,2,0,17,0,0,0,0
"em_5250991",NA,5,1,0,7,0,0,0,0
"em_5160246",NA,5,0,0,5,0,0,0,0
"em_5316787",NA,4,3,0,14,0,0,0,0
"em_5371984",NA,4,2,48,19,11,49,1,0
"em_5193051",NA,4,2,0,44,4,0,0,0
"em_5298156",NA,4,2,0,27,2,0,0,0
"em_5320495",NA,4,2,0,18,1,0,0,0
"em_4872689",NA,4,2,0,10,4,0,0,0
"em_5266082",NA,4,1,0,39,2,0,0,0
"em_5186751",NA,4,1,0,23,0,0,0,0
"em_5164533",NA,4,1,0,20,2,0,0,0
"em_5342665",NA,4,1,0,10,2,0,0,0
"em_5153420",NA,4,1,0,9,0,0,0,0
"em_5247739",NA,4,0,0,18,0,0,0,0
"em_5264083",NA,4,0,0,17,1,0,0,0
"em_5283899",NA,4,0,0,11,1,0,0,0
"em_5309451",NA,3,3,0,33,6,0,0,0
"em_5274438",NA,3,3,0,21,4,0,0,0
"em_5361571",NA,3,2,6,4,3,6,0,0
"em_5309471",NA,3,2,0,90,24,0,0,1
"em_5287781",NA,3,2,0,43,13,0,0,2
"em_5206328",NA,3,2,0,12,3,0,0,0
"em_5022377",NA,3,2,0,8,1,0,0,0
"em_5339388",NA,3,2,0,5,2,0,0,0
"em_5283994",NA,3,1,0,51,3,0,0,0
"em_5304514",NA,3,1,0,50,4,0,0,0
"em_5247651",NA,3,1,0,29,4,0,0,0
"em_5226983",NA,3,1,0,14,0,0,0,0
"em_5206355",NA,3,1,0,10,1,0,0,0
"em_5166826",NA,3,1,0,9,1,0,0,0
"em_5204119",NA,3,0,0,30,2,0,0,0
"em_5265980",NA,3,0,0,20,0,0,0,0
"em_5119659",NA,3,0,0,13,0,0,0,0
"em_5226924",NA,3,0,0,9,0,0,0,0
"em_5147136",NA,3,0,0,7,0,0,0,0
"em_5243253",NA,3,0,0,7,0,0,0,0
"em_5219415",NA,2,2,0,39,5,0,0,0
"em_5202124",NA,2,2,0,16,3,0,0,0
"em_5226914",NA,2,2,0,15,3,0,0,0
"em_5189860",NA,2,2,0,9,2,0,0,0
"em_5354449",NA,2,1,35,7,3,35,0,0
"em_5240364",NA,2,1,0,32,1,0,0,0
"em_5326945",NA,2,1,0,22,0,0,0,0
"em_5186722",NA,2,1,0,21,4,0,0,0
"em_5251033",NA,2,1,0,14,3,0,0,0
"em_5313573",NA,2,1,0,14,1,0,0,0
"em_5295034",NA,2,1,0,12,4,0,0,0
"em_5267850",NA,2,1,0,11,3,0,0,0
"em_5313461",NA,2,1,0,10,0,0,0,0
"em_5324410",NA,2,1,0,8,1,0,0,0
"em_5346447",NA,2,1,0,4,1,0,0,0
"em_5346070",NA,2,1,0,3,1,0,0,0
"em_5224674",NA,2,0,0,26,1,0,0,0
"em_5219616",NA,2,0,0,24,3,0,0,0
"em_5142772",NA,2,0,0,17,2,0,0,0
"em_5298223",NA,2,0,0,17,1,0,0,0
"em_5055454",NA,2,0,0,13,0,0,0,0
"em_5169988",NA,2,0,0,11,0,0,0,0
"em_5031134",NA,2,0,0,9,0,0,0,0
"em_5083269",NA,2,0,0,5,0,0,0,0
"em_5227042",NA,2,0,0,5,0,0,0,0
"em_5124392",NA,2,0,0,5,0,0,0,0
"em_5222579",NA,2,0,0,3,0,0,0,0
"em_5354337",NA,1,1,24,22,13,24,0,1
"em_5361539",NA,1,1,8,4,2,8,0,0
"em_5329254",NA,1,1,0,32,2,0,0,0
"em_5324169",NA,1,1,0,20,1,0,0,0
"em_5268089",NA,1,1,0,16,5,0,0,0
"em_5133041",NA,1,1,0,13,2,0,0,0
"em_5164552",NA,1,1,0,7,1,0,0,0
"em_5109373",NA,1,1,0,7,0,0,0,0
"em_5216416",NA,1,1,0,7,0,0,0,0
"em_5339471",NA,1,1,0,6,2,0,0,0
"em_5186703",NA,1,1,0,5,2,0,0,0
"em_5245336",NA,1,1,0,5,1,0,0,0
"em_4862185",NA,1,1,0,5,1,0,0,0
"em_5261218",NA,1,1,0,5,0,0,0,0
"em_5063406",NA,1,1,0,5,0,0,0,0
"em_5186786",NA,1,1,0,5,0,0,0,0
"em_4849989",NA,1,1,0,4,1,0,0,0
"em_5329203",NA,1,1,0,3,1,0,0,0
"em_4822048",NA,1,1,0,3,1,0,0,0
"em_5078602",NA,1,1,0,2,1,0,0,0
"em_4830325",NA,1,1,0,2,0,0,0,0
"em_5153355",NA,1,1,0,1,1,0,0,0
"em_5277710",NA,1,1,0,1,0,0,0,0
"em_4901493",NA,1,1,0,1,0,0,0,0
"em_5326958",NA,1,0,0,58,2,0,0,0
"em_5298069",NA,1,0,0,14,0,0,0,0
"em_5309319",NA,1,0,0,14,0,0,0,0
"em_5264159",NA,1,0,0,12,2,0,0,0
"em_5219728",NA,1,0,0,10,1,0,0,0
"em_5245381",NA,1,0,0,10,1,0,0,0
"em_5042235",NA,1,0,0,9,0,0,0,0
"em_5101877",NA,1,0,0,8,3,0,0,0
"em_5309464",NA,1,0,0,8,1,0,0,0
"em_5268246",NA,1,0,0,8,0,0,0,0
"em_4870823",NA,1,0,0,7,0,0,0,0
"em_5170018",NA,1,0,0,6,0,0,0,0
"em_5176688",NA,1,0,0,5,0,0,0,0
"em_5206404",NA,1,0,0,4,0,0,0,0
"em_4891267",NA,1,0,0,3,0,0,0,0
"em_5071900",NA,1,0,0,3,0,0,0,0
"em_5139732",NA,1,0,0,3,0,0,0,0
"em_5119797",NA,1,0,0,2,1,0,0,0
"em_5001668",NA,1,0,0,2,0,0,0,0
"em_5196427",NA,1,0,0,2,0,0,0,0
"em_5109336",NA,1,0,0,2,0,0,0,0
"em_5206377",NA,1,0,0,2,0,0,0,0
"em_5081361",NA,1,0,0,2,0,0,0,0
"em_5065716",NA,1,0,0,2,0,0,0,0
"em_5058775",NA,1,0,0,2,0,0,0,0
"em_5199587",NA,1,0,0,1,0,0,0,1
"em_5095277",NA,1,0,0,1,0,0,0,0
"em_5283864",NA,1,0,0,1,0,0,0,0
"em_4973182",NA,1,0,0,1,0,0,0,0
"em_5116018",NA,1,0,0,1,0,0,0,0
"em_5354463",NA,0,0,118,0,0,118,0,0
"em_5354446",NA,0,0,118,0,0,118,0,0
"em_5354425",NA,0,0,27,2,2,27,0,0
"em_5370912",NA,0,0,27,1,1,27,0,0
"em_5361540",NA,0,0,8,1,1,8,0,0
"em_5369191",NA,0,0,4,2,2,4,0,0
"em_5365436",NA,0,0,2,5,1,2,0,0
"em_5369049",NA,0,0,2,0,0,2,0,0
"em_5369046",NA,0,0,2,0,0,2,0,0
"em_5369019",NA,0,0,2,0,0,2,0,0
"em_5369032",NA,0,0,2,0,0,2,0,0
"em_5369005",NA,0,0,2,0,0,2,0,0
"em_5366773",NA,0,0,1,2,1,1,0,0
"em_5285975",NA,0,0,0,41,3,0,0,0
"em_5320552",NA,0,0,0,31,1,0,0,1
"em_5160315",NA,0,0,0,31,0,0,0,0
"em_5280653",NA,0,0,0,22,0,0,0,0
"em_5216548",NA,0,0,0,19,0,0,0,0
"em_5139339",NA,0,0,0,17,4,0,0,0
"em_5236868",NA,0,0,0,17,1,0,0,0
"em_5324525",NA,0,0,0,17,0,0,0,0
"em_5287988",NA,0,0,0,16,0,0,0,0
"em_5240467",NA,0,0,0,15,0,0,0,0
"em_5162849",NA,0,0,0,14,2,0,0,0
"em_5224699",NA,0,0,0,13,1,0,0,0
"em_5257906",NA,0,0,0,13,1,0,0,0
"em_4981424",NA,0,0,0,13,0,0,0,0
"em_5038460",NA,0,0,0,12,1,0,0,0
"em_5287919",NA,0,0,0,12,0,0,0,0
"em_5224716",NA,0,0,0,11,2,0,0,0
"em_5024671",NA,0,0,0,11,1,0,0,0
"em_5261320",NA,0,0,0,11,0,0,0,0
"em_5122522",NA,0,0,0,11,0,0,0,0
"em_5204218",NA,0,0,0,11,0,0,0,0
"em_5160159",NA,0,0,0,10,1,0,0,0
"em_5264179",NA,0,0,0,10,0,0,0,0
"em_5144947",NA,0,0,0,10,0,0,0,0
"em_5162807",NA,0,0,0,9,2,0,0,0
"em_4923709",NA,0,0,0,9,1,0,0,0
"em_5237288",NA,0,0,0,9,0,0,0,0
"em_5129548",NA,0,0,0,9,0,0,0,0
"em_4903757",NA,0,0,0,8,3,0,0,0
"em_4963669",NA,0,0,0,8,2,0,0,0
"em_5247603",NA,0,0,0,8,1,0,0,0
"em_5105902",NA,0,0,0,8,1,0,0,0
"em_5119689",NA,0,0,0,8,0,0,0,0
"em_4957294",NA,0,0,0,8,0,0,0,0
"em_4979285",NA,0,0,0,8,0,0,0,0
"em_5049057",NA,0,0,0,8,0,0,0,0
"em_5136160",NA,0,0,0,8,0,0,0,0
"em_4911860",NA,0,0,0,8,0,0,0,0
"em_5227143",NA,0,0,0,7,3,0,0,0
"em_5184490",NA,0,0,0,7,2,0,0,0
"em_5287730",NA,0,0,0,7,2,0,0,0
"em_5065603",NA,0,0,0,7,2,0,0,0
"em_5196393",NA,0,0,0,7,1,0,0,0
"em_5230420",NA,0,0,0,7,1,0,0,0
"em_4943741",NA,0,0,0,7,1,0,0,0
"em_5258080",NA,0,0,0,7,0,0,0,1
"em_4939481",NA,0,0,0,7,0,0,0,0
"em_5085558",NA,0,0,0,7,0,0,0,0
"em_5083284",NA,0,0,0,7,0,0,0,0
"em_4883191",NA,0,0,0,7,0,0,0,0
"em_4903724",NA,0,0,0,6,2,0,0,0
"em_5164578",NA,0,0,0,6,2,0,0,0
"em_5044365",NA,0,0,0,6,1,0,0,0
"em_5153460",NA,0,0,0,6,1,0,0,0
"em_5132751",NA,0,0,0,6,1,0,0,0
"em_5144855",NA,0,0,0,6,1,0,0,0
"em_5245292",NA,0,0,0,6,0,0,0,0
"em_5044384",NA,0,0,0,6,0,0,0,0
"em_5182503",NA,0,0,0,6,0,0,0,0
"em_4997068",NA,0,0,0,6,0,0,0,0
"em_5176749",NA,0,0,0,6,0,0,0,0
"em_5133033",NA,0,0,0,5,1,0,0,1
"em_5226875",NA,0,0,0,5,1,0,0,0
"em_5179903",NA,0,0,0,5,1,0,0,0
"em_5233720",NA,0,0,0,5,1,0,0,0
"em_5142790",NA,0,0,0,5,1,0,0,0
"em_5199526",NA,0,0,0,5,1,0,0,0
"em_4947152",NA,0,0,0,5,1,0,0,0
"em_5316694",NA,0,0,0,5,1,0,0,0
"em_4963673",NA,0,0,0,5,0,0,0,0
"em_4961499",NA,0,0,0,5,0,0,0,0
"em_5020307",NA,0,0,0,5,0,0,0,0
"em_5101897",NA,0,0,0,5,0,0,0,0
"em_5139702",NA,0,0,0,5,0,0,0,0
"em_5233823",NA,0,0,0,5,0,0,0,0
"em_5243337",NA,0,0,0,5,0,0,0,0
"em_5106015",NA,0,0,0,5,0,0,0,0
"em_5258098",NA,0,0,0,5,0,0,0,0
"em_4842682",NA,0,0,0,4,1,0,0,0
"em_5042253",NA,0,0,0,4,1,0,0,0
"em_5005787",NA,0,0,0,4,1,0,0,0
"em_5037600",NA,0,0,0,4,1,0,0,0
"em_4883203",NA,0,0,0,4,0,0,0,0
"em_5061414",NA,0,0,0,4,0,0,0,0
"em_5304143",NA,0,0,0,4,0,0,0,0
"em_5103840",NA,0,0,0,4,0,0,0,0
"em_5000001",NA,0,0,0,4,0,0,0,0
"em_5063347",NA,0,0,0,4,0,0,0,0
"em_5065624",NA,0,0,0,4,0,0,0,0
"em_5230331",NA,0,0,0,4,0,0,0,0
"em_5193091",NA,0,0,0,4,0,0,0,0
"em_5247896",NA,0,0,0,4,0,0,0,0
"em_4913640",NA,0,0,0,4,0,0,0,0
"em_5184421",NA,0,0,0,4,0,0,0,0
"em_5245369",NA,0,0,0,4,0,0,0,0
"em_5316861",NA,0,0,0,3,2,0,0,0
"em_5206285",NA,0,0,0,3,2,0,0,0
"em_5251077",NA,0,0,0,3,1,0,0,0
"em_5136196",NA,0,0,0,3,1,0,0,0
"em_5243315",NA,0,0,0,3,1,0,0,0
"em_4943710",NA,0,0,0,3,1,0,0,0
"em_5061428",NA,0,0,0,3,1,0,0,0
"em_5044333",NA,0,0,0,3,1,0,0,0
"em_4842701",NA,0,0,0,3,1,0,0,0
"em_4933217",NA,0,0,0,3,1,0,0,0
"em_5166940",NA,0,0,0,3,1,0,0,0
"em_4899423",NA,0,0,0,3,1,0,0,0
"em_5147829",NA,0,0,0,3,0,0,0,0
"em_5103799",NA,0,0,0,3,0,0,0,0
"em_4969955",NA,0,0,0,3,0,0,0,0
"em_5078571",NA,0,0,0,3,0,0,0,0
"em_5173272",NA,0,0,0,3,0,0,0,0
"em_4903782",NA,0,0,0,3,0,0,0,0
"em_5105958",NA,0,0,0,3,0,0,0,0
"em_5122573",NA,0,0,0,3,0,0,0,0
"em_5274484",NA,0,0,0,3,0,0,0,0
"em_5202169",NA,0,0,0,3,0,0,0,0
"em_4881097",NA,0,0,0,3,0,0,0,0
"em_4943726",NA,0,0,0,3,0,0,0,0
"em_5277834",NA,0,0,0,3,0,0,0,0
"em_4857798",NA,0,0,0,3,0,0,0,0
"em_5010927",NA,0,0,0,3,0,0,0,0
"em_5301378",NA,0,0,0,3,0,0,0,0
"em_5150590",NA,0,0,0,3,0,0,0,0
"em_5024555",NA,0,0,0,3,0,0,0,0
"em_4976563",NA,0,0,0,3,0,0,0,0
"em_5341016",NA,0,0,0,3,0,0,0,0
"em_5017539",NA,0,0,0,3,0,0,0,0
"em_5157177",NA,0,0,0,3,0,0,0,0
"em_4947099",NA,0,0,0,3,0,0,0,0
"em_4899332",NA,0,0,0,3,0,0,0,0
"em_4950547",NA,0,0,0,3,0,0,0,0
"em_5085595",NA,0,0,0,3,0,0,0,0
"em_5071978",NA,0,0,0,3,0,0,0,0
"em_5186858",NA,0,0,0,3,0,0,0,0
"em_5267899",NA,0,0,0,3,0,0,0,0
"em_5196451",NA,0,0,0,3,0,0,0,0
"em_5022411",NA,0,0,0,3,0,0,0,0
"em_4983720",NA,0,0,0,3,0,0,0,0
"em_5237085",NA,0,0,0,3,0,0,0,0
"em_5184466",NA,0,0,0,3,0,0,0,0
"em_5179936",NA,0,0,0,3,0,0,0,0
"em_4923647",NA,0,0,0,3,0,0,0,0
"em_5091933",NA,0,0,0,3,0,0,0,0
"em_4950511",NA,0,0,0,3,0,0,0,0
"em_5004242",NA,0,0,0,3,0,0,0,0
"em_4957258",NA,0,0,0,2,2,0,0,0
"em_5124475",NA,0,0,0,2,1,0,0,0
"em_5124455",NA,0,0,0,2,1,0,0,0
"em_5142814",NA,0,0,0,2,1,0,0,0
"em_4881116",NA,0,0,0,2,1,0,0,0
"em_5122547",NA,0,0,0,2,1,0,0,0
"em_5088679",NA,0,0,0,2,1,0,0,0
"em_4862125",NA,0,0,0,2,1,0,0,0
"em_5071871",NA,0,0,0,2,1,0,0,0
"em_4881145",NA,0,0,0,2,1,0,0,0
"em_4886549",NA,0,0,0,2,1,0,0,0
"em_5065608",NA,0,0,0,2,0,0,0,0
"em_5139844",NA,0,0,0,2,0,0,0,0
"em_4896631",NA,0,0,0,2,0,0,0,0
"em_5027875",NA,0,0,0,2,0,0,0,0
"em_5316684",NA,0,0,0,2,0,0,0,0
"em_5313435",NA,0,0,0,2,0,0,0,0
"em_5088792",NA,0,0,0,2,0,0,0,0
"em_5176782",NA,0,0,0,2,0,0,0,0
"em_4954063",NA,0,0,0,2,0,0,0,0
"em_5105903",NA,0,0,0,2,0,0,0,0
"em_4959517",NA,0,0,0,2,0,0,0,0
"em_5022429",NA,0,0,0,2,0,0,0,0
"em_5237373",NA,0,0,0,2,0,0,0,0
"em_4979320",NA,0,0,0,2,0,0,0,0
"em_5126882",NA,0,0,0,2,0,0,0,0
"em_5280677",NA,0,0,0,2,0,0,0,0
"em_4929932",NA,0,0,0,2,0,0,0,0
"em_4963710",NA,0,0,0,2,0,0,0,0
"em_5103821",NA,0,0,0,2,0,0,0,0
"em_5040258",NA,0,0,0,2,0,0,0,0
"em_5164598",NA,0,0,0,2,0,0,0,0
"em_4997210",NA,0,0,0,2,0,0,0,0
"em_5007691",NA,0,0,0,2,0,0,0,0
"em_4910446",NA,0,0,0,2,0,0,0,0
"em_4966743",NA,0,0,0,2,0,0,0,0
"em_5291640",NA,0,0,0,2,0,0,0,0
"em_5112737",NA,0,0,0,2,0,0,0,0
"em_5189837",NA,0,0,0,2,0,0,0,0
"em_5037637",NA,0,0,0,2,0,0,0,0
"em_5105884",NA,0,0,0,2,0,0,0,0
"em_5098794",NA,0,0,0,2,0,0,0,0
"em_5139908",NA,0,0,0,2,0,0,0,0
"em_4999944",NA,0,0,0,2,0,0,0,0
"em_5339376",NA,0,0,0,2,0,0,0,0
"em_5063367",NA,0,0,0,2,0,0,0,0
"em_5147819",NA,0,0,0,2,0,0,0,0
"em_5017641",NA,0,0,0,2,0,0,0,0
"em_4865501",NA,0,0,0,2,0,0,0,0
"em_5058670",NA,0,0,0,2,0,0,0,0
"em_5101929",NA,0,0,0,2,0,0,0,0
"em_5240496",NA,0,0,0,2,0,0,0,0
"em_5157331",NA,0,0,0,2,0,0,0,0
"em_5020339",NA,0,0,0,2,0,0,0,0
"em_5109402",NA,0,0,0,2,0,0,0,0
"em_4838570",NA,0,0,0,2,0,0,0,0
"em_4828575",NA,0,0,0,2,0,0,0,0
"em_5040286",NA,0,0,0,2,0,0,0,0
"em_5306414",NA,0,0,0,2,0,0,0,0
"em_4883196",NA,0,0,0,2,0,0,0,0
"em_5022389",NA,0,0,0,2,0,0,0,0
"em_5162833",NA,0,0,0,2,0,0,0,0
"em_5014280",NA,0,0,0,2,0,0,0,0
"em_4913689",NA,0,0,0,2,0,0,0,0
"em_4947193",NA,0,0,0,2,0,0,0,0
"em_4899354",NA,0,0,0,2,0,0,0,0
"em_4969878",NA,0,0,0,2,0,0,0,0
"em_5040244",NA,0,0,0,2,0,0,0,0
"em_5061444",NA,0,0,0,1,1,0,0,0
"em_4842665",NA,0,0,0,1,1,0,0,0
"em_4859912",NA,0,0,0,1,1,0,0,0
"em_4981442",NA,0,0,0,1,1,0,0,0
"em_5017571",NA,0,0,0,1,1,0,0,0
"em_5320450",NA,0,0,0,1,1,0,0,0
"em_4961581",NA,0,0,0,1,1,0,0,0
"em_5005783",NA,0,0,0,1,1,0,0,0
"em_5346065",NA,0,0,0,1,1,0,0,0
"em_5061465",NA,0,0,0,1,1,0,0,0
"em_5042288",NA,0,0,0,1,1,0,0,0
"em_4939575",NA,0,0,0,1,1,0,0,0
"em_4919579",NA,0,0,0,1,1,0,0,0
"em_4936768",NA,0,0,0,1,1,0,0,0
"em_4872838",NA,0,0,0,1,1,0,0,0
"em_5166903",NA,0,0,0,1,1,0,0,0
"em_4983791",NA,0,0,0,1,1,0,0,0
"em_4857826",NA,0,0,0,1,1,0,0,0
"em_5348100",NA,0,0,0,1,1,0,0,0
"em_5341017",NA,0,0,0,1,0,0,0,0
"em_5166795",NA,0,0,0,1,0,0,0,0
"em_4879184",NA,0,0,0,1,0,0,0,0
"em_4889855",NA,0,0,0,1,0,0,0,0
"em_5034392",NA,0,0,0,1,0,0,0,0
"em_5083303",NA,0,0,0,1,0,0,0,0
"em_4983707",NA,0,0,0,1,0,0,0,0
"em_4936657",NA,0,0,0,1,0,0,0,0
"em_4876348",NA,0,0,0,1,0,0,0,0
"em_5122592",NA,0,0,0,1,0,0,0,0
"em_5142860",NA,0,0,0,1,0,0,0,0
"em_4883174",NA,0,0,0,1,0,0,0,0
"em_5098736",NA,0,0,0,1,0,0,0,0
"em_5052201",NA,0,0,0,1,0,0,0,0
"em_5081383",NA,0,0,0,1,0,0,0,0
"em_4957421",NA,0,0,0,1,0,0,0,0
"em_5247802",NA,0,0,0,1,0,0,0,0
"em_5001614",NA,0,0,0,1,0,0,0,0
"em_5027808",NA,0,0,0,1,0,0,0,0
"em_5092017",NA,0,0,0,1,0,0,0,0
"em_4907158",NA,0,0,0,1,0,0,0,0
"em_5150629",NA,0,0,0,1,0,0,0,0
"em_4936692",NA,0,0,0,1,0,0,0,0
"em_4825249",NA,0,0,0,1,0,0,0,0
"em_5031187",NA,0,0,0,1,0,0,0,0
"em_5027841",NA,0,0,0,1,0,0,0,0
"em_5119759",NA,0,0,0,1,0,0,0,0
"em_5227090",NA,0,0,0,1,0,0,0,0
"em_4913608",NA,0,0,0,1,0,0,0,0
"em_4876376",NA,0,0,0,1,0,0,0,0
"em_5240397",NA,0,0,0,1,0,0,0,0
"em_5071940",NA,0,0,0,1,0,0,0,0
"em_5144896",NA,0,0,0,1,0,0,0,0
"em_4825219",NA,0,0,0,1,0,0,0,0
"em_4835640",NA,0,0,0,1,0,0,0,0
"em_4896573",NA,0,0,0,1,0,0,0,0
"em_5213004",NA,0,0,0,1,0,0,0,0
"em_5206431",NA,0,0,0,1,0,0,0,0
"em_5010960",NA,0,0,0,1,0,0,0,0
"em_5170086",NA,0,0,0,1,0,0,0,0
"em_5153497",NA,0,0,0,1,0,0,0,0
"em_5212967",NA,0,0,0,1,0,0,0,0
"em_4957468",NA,0,0,0,1,0,0,0,0
"em_4838555",NA,0,0,0,1,0,0,0,0
"em_4997173",NA,0,0,0,1,0,0,0,0
"em_4976698",NA,0,0,0,1,0,0,0,0
"em_5055522",NA,0,0,0,1,0,0,0,0
"em_4983830",NA,0,0,0,1,0,0,0,0
"em_5337383",NA,0,0,0,1,0,0,0,0
"em_5176816",NA,0,0,0,1,0,0,0,0
"em_5280744",NA,0,0,0,1,0,0,0,0
"em_5014369",NA,0,0,0,1,0,0,0,0
"em_4979341",NA,0,0,0,1,0,0,0,0
"em_5126854",NA,0,0,0,1,0,0,0,0
"em_4990281",NA,0,0,0,1,0,0,0,0
"em_5068732",NA,0,0,0,1,0,0,0,0
"em_4961521",NA,0,0,0,1,0,0,0,0
"em_5219863",NA,0,0,0,1,0,0,0,0
"em_4845203",NA,0,0,0,1,0,0,0,0
"em_5031264",NA,0,0,0,1,0,0,0,0
"em_4840609",NA,0,0,0,1,0,0,0,0
"em_5132669",NA,0,0,0,1,0,0,0,0
"em_4840597",NA,0,0,0,1,0,0,0,0
"em_5250931",NA,0,0,0,1,0,0,0,0
"em_5170050",NA,0,0,0,1,0,0,0,0
"em_5164518",NA,0,0,0,1,0,0,0,0
"em_4842694",NA,0,0,0,1,0,0,0,0
"em_5147246",NA,0,0,0,1,0,0,0,0
"em_5088722",NA,0,0,0,1,0,0,0,0
"em_5230449",NA,0,0,0,1,0,0,0,0
"em_4838536",NA,0,0,0,1,0,0,0,0
"em_5075266",NA,0,0,0,1,0,0,0,0
"em_4990180",NA,0,0,0,1,0,0,0,0
"em_5091858",NA,0,0,0,1,0,0,0,0
"em_4991351",NA,0,0,0,1,0,0,0,0
"em_5144930",NA,0,0,0,1,0,0,0,0
"em_5001597",NA,0,0,0,1,0,0,0,0
"em_5219440",NA,0,0,0,1,0,0,0,0
"em_4986969",NA,0,0,0,1,0,0,0,0
"em_4983744",NA,0,0,0,1,0,0,0,0
"em_5136238",NA,0,0,0,1,0,0,0,0
"em_5157264",NA,0,0,0,1,0,0,0,0
"em_4919490",NA,0,0,0,1,0,0,0,0
"em_5052315",NA,0,0,0,1,0,0,0,0
"em_5044402",NA,0,0,0,1,0,0,0,0
"em_5095381",NA,0,0,0,1,0,0,0,0
"em_5216605",NA,0,0,0,1,0,0,0,0
"em_5024865",NA,0,0,0,1,0,0,0,0
"em_5058747",NA,0,0,0,1,0,0,0,0
"em_5166877",NA,0,0,0,1,0,0,0,0
"em_4959614",NA,0,0,0,1,0,0,0,0
"em_4986930",NA,0,0,0,1,0,0,0,0
"em_4876291",NA,0,0,0,1,0,0,0,0
"em_5147323",NA,0,0,0,1,0,0,0,0
"em_5115948",NA,0,0,0,1,0,0,0,0
"em_4869148",NA,0,0,0,1,0,0,0,0
"em_5147292",NA,0,0,0,1,0,0,0,0
"em_5189868",NA,0,0,0,1,0,0,0,0
"em_5184390",NA,0,0,0,1,0,0,0,0
"em_4851877",NA,0,0,0,1,0,0,0,0
"em_5034461",NA,0,0,0,1,0,0,0,0
"em_4981406",NA,0,0,0,1,0,0,0,0
"em_5186821",NA,0,0,0,1,0,0,0,0
"em_5295058",NA,0,0,0,1,0,0,0,0
"em_5022445",NA,0,0,0,1,0,0,0,0
"em_5224626",NA,0,0,0,1,0,0,0,0
"em_4842671",NA,0,0,0,1,0,0,0,0
"em_4819898",NA,0,0,0,1,0,0,0,0
"em_4910485",NA,0,0,0,1,0,0,0,0
"em_4933395",NA,0,0,0,1,0,0,0,0
"em_5024833",NA,0,0,0,1,0,0,0,0
"em_5271483",NA,0,0,0,1,0,0,0,0
"em_4857776",NA,0,0,0,1,0,0,0,0
"em_5285918",NA,0,0,0,1,0,0,0,0
"em_4923824",NA,0,0,0,1,0,0,0,0
"em_5233952",NA,0,0,0,1,0,0,0,0
"em_4840563",NA,0,0,0,1,0,0,0,0
"em_4862266",NA,0,0,0,1,0,0,0,0
"em_4851790",NA,0,0,0,1,0,0,0,0
"em_4943787",NA,0,0,0,1,0,0,0,0
"em_4997145",NA,0,0,0,1,0,0,0,0
"em_5124429",NA,0,0,0,1,0,0,0,0
"em_5007726",NA,0,0,0,1,0,0,0,0
"em_4926872",NA,0,0,0,1,0,0,0,0
"em_5274323",NA,0,0,0,1,0,0,0,0
"em_5085643",NA,0,0,0,1,0,0,0,0
"em_5361460",NA,1493,1114,17699,8618,6158,17741,42,11
"em_5361438",NA,1419,1030,14477,7593,5297,14521,44,11
"em_5357419",NA,1247,868,13929,7323,4983,13967,38,8
"em_5357448",NA,1166,863,13714,7100,4974,13763,49,13
"em_5354154",NA,1071,807,13156,6833,4923,13195,39,6
"em_5374619",NA,1067,792,13948,5880,4436,13966,18,2
"em_5369085",NA,726,561,9279,4643,3273,9295,16,10
"em_5374609",NA,685,518,7680,3516,2583,7694,14,2
"em_5365272",NA,617,443,6229,3158,2136,6250,21,5
"em_5371897",NA,592,456,7812,3308,2472,7830,18,8
"em_5354140",NA,440,313,4364,2366,1593,4395,31,3
"em_5365297",NA,423,316,5350,2481,1822,5399,49,3
"em_5369064",NA,337,253,3546,1699,1186,3559,13,0
"em_5371910",NA,323,248,4409,2072,1472,4426,17,5
"em_5351759",NA,245,125,-17,1385,547,0,17,3
"em_5351782",NA,122,86,-9,982,457,0,9,0
"em_5349092",NA,111,64,-18,645,294,0,18,1
"em_5346091",NA,87,45,-17,704,258,0,17,3
"em_5349106",NA,86,48,-9,393,190,0,9,0
"em_5346127",NA,63,29,-31,286,127,0,31,2
"em_5342513",NA,39,24,0,318,105,0,0,0
"em_5335709",NA,32,7,0,130,42,0,0,1
"em_5369077",NA,30,19,83,79,45,86,3,0
"em_5361451",NA,28,21,85,60,38,89,4,0
"em_5354147",NA,26,18,106,95,52,112,6,0
"em_5374613",NA,25,20,86,79,40,90,4,0
"em_5371905",NA,25,13,84,42,34,87,3,0
"em_5331697",NA,24,9,0,176,50,0,0,0
"em_5365287",NA,22,16,93,89,52,95,2,0
"em_5339276",NA,22,16,0,223,73,0,0,1
"em_5357433",NA,22,15,81,79,43,85,4,0
"em_5335685",NA,13,8,0,126,35,0,0,0
"em_5326811",NA,12,3,0,61,15,0,0,0
"em_5319906",NA,10,6,0,79,19,0,0,0
"em_5351771",NA,7,3,0,18,6,0,0,0
"em_5306342",NA,6,4,0,46,12,0,0,0
"em_5306351",NA,6,1,0,39,6,0,0,0
"em_5331661",NA,5,5,0,67,21,0,0,0
"em_5329097",NA,5,3,0,85,22,0,0,0
"em_5304071",NA,5,3,0,45,3,0,0,2
"em_5300972",NA,5,1,0,64,11,0,0,0
"em_5148488",NA,5,0,0,14,1,0,0,1
"em_5316557",NA,4,3,0,84,20,0,0,0
"em_5349101",NA,4,2,0,23,5,0,0,0
"em_5316525",NA,3,2,0,59,13,0,0,1
"em_5285792",NA,3,2,0,13,1,0,0,0
"em_5319878",NA,3,1,0,64,17,0,0,0
"em_5294471",NA,3,1,0,22,8,0,0,1
"em_5240203",NA,3,1,0,13,3,0,0,0
"em_5312900",NA,3,0,0,66,17,0,0,0
"em_5329108",NA,2,2,0,43,17,0,0,0
"em_5280508",NA,2,2,0,18,3,0,0,0
"em_5304083",NA,2,1,0,53,6,0,0,0
"em_5300990",NA,2,1,0,25,7,0,0,0
"em_5283726",NA,2,1,0,16,4,0,0,0
"em_5267811",NA,2,1,0,15,3,0,0,0
"em_5219535",NA,2,1,0,12,2,0,0,0
"em_5294402",NA,2,0,0,27,7,0,0,0
"em_5247514",NA,2,0,0,15,3,0,0,0
"em_5186806",NA,2,0,0,11,1,0,0,0
"em_5192885",NA,2,0,0,4,0,0,0,0
"em_5245250",NA,2,0,0,2,0,0,0,0
"em_5309226",NA,1,1,0,37,10,0,0,0
"em_5312851",NA,1,1,0,31,4,0,0,0
"em_5224550",NA,1,1,0,21,0,0,0,0
"em_5216750",NA,1,1,0,19,4,0,0,0
"em_5219544",NA,1,1,0,19,3,0,0,0
"em_5202028",NA,1,1,0,19,3,0,0,0
"em_5274000",NA,1,1,0,18,3,0,0,0
"em_5271095",NA,1,1,0,16,2,0,0,0
"em_5236753",NA,1,1,0,15,3,0,0,0
"em_5230195",NA,1,1,0,14,4,0,0,0
"em_5267829",NA,1,1,0,13,1,0,0,0
"em_5233591",NA,1,1,0,9,1,0,0,0
"em_5233579",NA,1,1,0,8,1,0,0,0
"em_5243199",NA,1,1,0,6,2,0,0,0
"em_5291223",NA,1,1,0,2,0,0,0,0
"em_5250799",NA,1,0,0,38,9,0,0,0
"em_5297779",NA,1,0,0,36,5,0,0,0
"em_5236701",NA,1,0,0,25,6,0,0,0
"em_5250751",NA,1,0,0,17,2,0,0,0
"em_5253991",NA,1,0,0,15,3,0,0,0
"em_5161827",NA,1,0,0,12,2,0,0,0
"em_5162702",NA,1,0,0,10,3,0,0,0
"em_5346120",NA,1,0,0,3,0,0,0,0
"em_5129116",NA,1,0,0,2,0,0,0,0
"em_5260970",NA,1,0,0,1,0,0,0,0
"em_5365286",NA,0,0,8,3,3,8,0,0
"em_5369075",NA,0,0,6,3,2,6,0,0
"em_5354146",NA,0,0,6,0,0,6,0,0
"em_5371901",NA,0,0,4,0,0,4,0,0
"em_5357428",NA,0,0,4,0,0,4,0,0
"em_5374612",NA,0,0,2,0,0,2,0,0
"em_5361445",NA,0,0,1,0,0,1,0,0
"em_5357441",NA,0,0,1,0,0,1,0,0
"em_5361448",NA,0,0,1,0,0,1,0,0
"em_5274093",NA,0,0,0,30,4,0,0,0
"em_5287693",NA,0,0,0,28,9,0,0,0
"em_5297809",NA,0,0,0,26,10,0,0,0
"em_5309240",NA,0,0,0,25,7,0,0,0
"em_5254060",NA,0,0,0,22,4,0,0,0
"em_5260921",NA,0,0,0,22,2,0,0,0
"em_5209367",NA,0,0,0,21,9,0,0,0
"em_5291239",NA,0,0,0,19,5,0,0,0
"em_5287721",NA,0,0,0,19,4,0,0,0
"em_5277633",NA,0,0,0,19,4,0,0,0
"em_5204069",NA,0,0,0,19,3,0,0,0
"em_5263921",NA,0,0,0,18,4,0,0,0
"em_5291203",NA,0,0,0,18,1,0,0,0
"em_5196097",NA,0,0,0,16,6,0,0,0
"em_5285800",NA,0,0,0,16,3,0,0,0
"em_5260984",NA,0,0,0,16,3,0,0,0
"em_5257775",NA,0,0,0,16,1,0,0,0
"em_5247467",NA,0,0,0,15,3,0,0,0
"em_5283686",NA,0,0,0,15,3,0,0,0
"em_5180865",NA,0,0,0,15,2,0,0,0
"em_5164449",NA,0,0,0,13,2,0,0,0
"em_5240251",NA,0,0,0,12,6,0,0,0
"em_5280532",NA,0,0,0,12,4,0,0,0
"em_5245245",NA,0,0,0,12,4,0,0,0
"em_5224526",NA,0,0,0,12,3,0,0,0
"em_5216797",NA,0,0,0,12,3,0,0,0
"em_5265935",NA,0,0,0,12,3,0,0,0
"em_5277614",NA,0,0,0,12,1,0,0,0
"em_5265886",NA,0,0,0,11,2,0,0,0
"em_5154594",NA,0,0,0,11,1,0,0,0
"em_5212765",NA,0,0,0,11,1,0,0,0
"em_5257801",NA,0,0,0,11,1,0,0,0
"em_5331687",NA,0,0,0,11,0,0,0,0
"em_5243141",NA,0,0,0,10,2,0,0,0
"em_5209340",NA,0,0,0,10,2,0,0,0
"em_5192871",NA,0,0,0,10,1,0,0,0
"em_5158306",NA,0,0,0,10,1,0,0,0
"em_5245253",NA,0,0,0,9,3,0,0,0
"em_5206238",NA,0,0,0,9,2,0,0,0
"em_5263873",NA,0,0,0,9,2,0,0,0
"em_5199218",NA,0,0,0,8,4,0,0,0
"em_5222479",NA,0,0,0,8,4,0,0,0
"em_5222461",NA,0,0,0,8,2,0,0,0
"em_5271153",NA,0,0,0,8,1,0,0,0
"em_5174863",NA,0,0,0,8,0,0,0,0
"em_5206255",NA,0,0,0,8,0,0,0,0
"em_5226824",NA,0,0,0,7,3,0,0,0
"em_5178164",NA,0,0,0,7,2,0,0,0
"em_5230179",NA,0,0,0,6,4,0,0,0
"em_5189714",NA,0,0,0,6,2,0,0,0
"em_5122184",NA,0,0,0,6,2,0,0,0
"em_5182844",NA,0,0,0,6,0,0,0,0
"em_5171659",NA,0,0,0,5,0,0,0,0
"em_5335699",NA,0,0,0,4,1,0,0,0
"em_5212730",NA,0,0,0,4,0,0,0,0
"em_5339289",NA,0,0,0,3,1,0,0,0
"em_5184251",NA,0,0,0,3,0,0,0,0
"em_5206250",NA,0,0,0,3,0,0,0,0
"em_5316541",NA,0,0,0,2,2,0,0,0
"em_5342534",NA,0,0,0,2,1,0,0,0
"em_5226796",NA,0,0,0,2,0,0,0,0
"em_5319894",NA,0,0,0,2,0,0,0,0
"em_5123951",NA,0,0,0,2,0,0,0,0
"em_5329102",NA,0,0,0,2,0,0,0,0
"em_5178169",NA,0,0,0,1,1,0,0,0
"em_5351765",NA,0,0,0,1,1,0,0,0
"em_5312871",NA,0,0,0,1,1,0,0,0
"em_5250793",NA,0,0,0,1,1,0,0,0
"em_5129148",NA,0,0,0,1,0,0,0,0
"em_5126125",NA,0,0,0,1,0,0,0,0
"em_5124005",NA,0,0,0,1,0,0,0,0
"em_5236746",NA,0,0,0,1,0,0,0,0
"em_5226814",NA,0,0,0,1,0,0,0,0
"em_5162705",NA,0,0,0,1,0,0,0,0
"em_5148513",NA,0,0,0,1,0,0,0,0
"em_5122247",NA,0,0,0,1,0,0,0,0
"em_5189735",NA,0,0,0,1,0,0,0,0
"em_5182855",NA,0,0,0,1,0,0,0,0
"em_5230188",NA,0,0,0,1,0,0,0,0
"em_5171666",NA,0,0,0,1,0,0,0,0
"em_5280519",NA,0,0,0,1,0,0,0,0
"em_5283722",NA,0,0,0,1,0,0,0,0
"em_5341271",NA,5513,2700,0,29490,11294,0,0,74
"em_5362542",NA,833,592,6664,4659,2842,6809,145,17
"em_5337489",NA,51,20,0,435,62,0,0,0
"em_5337500",NA,32,18,0,259,40,0,0,0
"em_5335759",NA,32,0,0,5,0,0,0,0
"em_5357915",NA,18,4,50,69,13,50,0,0
"em_5231915",NA,15,8,0,63,5,0,0,0
"em_5210846",NA,14,7,0,48,5,0,0,0
"em_5272705",NA,12,5,0,91,3,0,0,0
"em_5314567",NA,11,6,0,65,8,0,0,0
"em_5293030",NA,11,3,0,116,8,0,0,0
"em_5151976",NA,11,0,0,31,1,0,0,0
"em_5252631",NA,10,5,0,69,5,0,0,0
"em_5272712",NA,9,2,0,54,2,0,0,0
"em_5314569",NA,7,6,0,68,5,0,0,0
"em_5191125",NA,7,1,0,23,1,0,0,0
"em_5090092",NA,6,5,0,24,1,0,0,0
"em_5362209",NA,5,4,35,20,6,35,0,0
"em_5359244",NA,5,2,35,48,7,35,0,0
"em_5029136",NA,5,2,0,21,0,0,0,0
"em_4988290",NA,4,3,0,13,0,0,0,0
"em_5008988",NA,4,2,0,6,0,0,0,0
"em_5008985",NA,4,1,0,21,0,0,0,0
"em_5272473",NA,4,0,0,2,0,0,0,0
"em_5174756",NA,2,2,0,26,8,0,0,0
"em_4908538",NA,2,2,0,5,0,0,0,0
"em_5272476",NA,2,1,0,31,9,0,0,0
"em_5050397",NA,2,1,0,12,1,0,0,0
"em_5174795",NA,2,1,0,8,0,0,0,0
"em_5090615",NA,2,1,0,7,1,0,0,0
"em_4826741",NA,2,1,0,3,1,0,0,0
"em_5293032",NA,2,0,0,31,3,0,0,0
"em_5357876",NA,1,1,46,10,5,46,0,0
"em_5355831",NA,1,1,46,9,8,46,0,0
"em_4908536",NA,1,1,0,7,0,0,0,0
"em_4968077",NA,1,1,0,3,0,0,0,0
"em_5174793",NA,1,1,-1,39,2,0,1,0
"em_5231921",NA,1,0,0,26,1,0,0,0
"em_4887921",NA,1,0,0,18,1,0,0,0
"em_4948616",NA,1,0,0,13,1,0,0,0
"em_4887923",NA,1,0,0,10,0,0,0,0
"em_5130889",NA,1,0,0,8,1,0,0,0
"em_5191127",NA,1,0,0,7,0,0,0,0
"em_5176983",NA,1,0,0,1,0,0,0,0
"em_5359069",NA,0,0,46,10,9,46,0,0
"em_5359222",NA,0,0,35,3,3,35,0,0
"em_5362536",NA,0,0,4,4,1,5,1,0
"em_5070061",NA,0,0,0,26,0,0,0,0
"em_5130887",NA,0,0,0,23,1,0,0,0
"em_5012293",NA,0,0,0,22,9,0,0,0
"em_5252633",NA,0,0,0,20,3,0,0,0
"em_4968074",NA,0,0,0,17,0,0,0,0
"em_5313341",NA,0,0,0,16,1,0,0,0
"em_5110828",NA,0,0,0,15,1,0,0,0
"em_5210848",NA,0,0,0,15,0,0,0,0
"em_4846667",NA,0,0,0,10,1,0,0,0
"em_5298331",NA,0,0,0,10,0,0,0,0
"em_4928290",NA,0,0,0,7,1,0,0,0
"em_5164771",NA,0,0,0,7,0,0,0,0
"em_5151978",NA,0,0,0,7,0,0,0,0
"em_5219948",NA,0,0,0,5,0,0,0,0
"em_4928292",NA,0,0,0,5,0,0,0,0
"em_5050399",NA,0,0,0,4,0,0,0,0
"em_5301480",NA,0,0,0,3,0,0,0,0
"em_5324091",NA,0,0,0,2,1,0,0,0
"em_5341111",NA,0,0,0,2,1,0,0,0
"em_5295174",NA,0,0,0,2,0,0,0,0
"em_5199717",NA,0,0,0,2,0,0,0,0
"em_4846672",NA,0,0,0,2,0,0,0,0
"em_5090094",NA,0,0,0,2,0,0,0,0
"em_5313339",NA,0,0,0,2,0,0,0,0
"em_4988292",NA,0,0,0,2,0,0,0,0
"em_5070064",NA,0,0,0,1,1,0,0,0
"em_5337499",NA,0,0,0,1,1,0,0,0
"em_5186964",NA,0,0,0,1,0,0,0,0
"em_5167330",NA,0,0,0,1,0,0,0,0
"em_4867174",NA,0,0,0,1,0,0,0,0
"em_5266191",NA,0,0,0,1,0,0,0,0
"em_5209703",NA,0,0,0,1,0,0,0,0
"em_5193254",NA,0,0,0,1,0,0,0,0
"em_5173528",NA,0,0,0,1,0,0,0,0
"em_5258137",NA,0,0,0,1,0,0,0,0
"em_5313434",NA,0,0,0,1,0,0,0,0
"em_5206544",NA,0,0,0,1,0,0,0,0
"em_5301473",NA,0,0,0,1,0,0,0,0
"em_5170225",NA,0,0,0,1,0,0,0,0
"em_5278096",NA,0,0,0,1,0,0,0,0
"em_5180090",NA,0,0,0,1,0,0,0,0
"em_5245466",NA,0,0,0,1,0,0,0,0
"em_5301527",NA,0,0,0,1,0,0,0,0
"em_4826740",NA,0,0,0,1,0,0,0,0
